start_date,end_date,creates,edits,deletes,total
2015-10-10 00:00:00,2015-10-11 00:00:00,424,471,116,1011
2015-10-11 00:00:00,2015-10-12 00:00:00,671,359,85,1115
2015-10-12 00:00:00,2015-10-13 00:00:00,771,250,91,1112
2015-10-13 00:00:00,2015-10-14 00:00:00,385,12,0,397
2015-10-14 00:00:00,2015-10-15 00:00:00,1369,129,30,1528
2015-10-15 00:00:00,2015-10-16 00:00:00,1076,237,659,1972
2015-10-16 00:00:00,2015-10-17 00:00:00,3274,168,139,3581
2015-10-17 00:00:00,2015-10-18 00:00:00,4267,219,39,4525
2015-10-18 00:00:00,2015-10-19 00:00:00,1019,194,223,1436
2015-10-19 00:00:00,2015-10-20 00:00:00,682,182,272,1136
2015-10-20 00:00:00,2015-10-21 00:00:00,837,708,148,1693
2015-10-21 00:00:00,2015-10-22 00:00:00,2024,532,57,2613
2015-10-22 00:00:00,2015-10-23 00:00:00,9337,691,296,10324
2015-10-23 00:00:00,2015-10-24 00:00:00,3051,802,321,4174
2015-10-24 00:00:00,2015-10-25 00:00:00,17,7,0,24
2015-10-25 00:00:00,2015-10-26 00:00:00,226,14,4,244
2015-10-26 00:00:00,2015-10-27 00:00:00,2830,587,345,3762
2015-10-27 00:00:00,2015-10-28 00:00:00,8818,4265,2327,15410
2015-10-28 00:00:00,2015-10-29 00:00:00,3560,5495,539,9594
2015-10-29 00:00:00,2015-10-30 00:00:00,6226,6790,2175,15191
2015-10-30 00:00:00,2015-10-31 00:00:00,11336,1978,1579,14893
2015-10-31 00:00:00,2015-11-01 00:00:00,362,10,0,372
2015-11-01 00:00:00,2015-11-02 00:00:00,1415,3319,83,4817
2015-11-02 00:00:00,2015-11-03 00:00:00,85,3,39,127
2015-11-03 00:00:00,2015-11-04 00:00:00,7643,5551,3900,17094
2015-11-04 00:00:00,2015-11-05 00:00:00,7823,3299,1432,12554
2015-11-05 00:00:00,2015-11-06 00:00:00,2550,801,228,3579
2015-11-06 00:00:00,2015-11-07 00:00:00,4074,1723,622,6419
2015-11-07 00:00:00,2015-11-08 00:00:00,2960,853,1429,5242
2015-11-08 00:00:00,2015-11-09 00:00:00,4401,1865,1321,7587
2015-11-09 00:00:00,2015-11-10 00:00:00,2163,1128,1241,4532
2015-11-10 00:00:00,2015-11-11 00:00:00,8327,3246,2451,14024
2015-11-11 00:00:00,2015-11-12 00:00:00,5693,5134,1047,11874
2015-11-12 00:00:00,2015-11-13 00:00:00,1675,359,164,2198
2015-11-13 00:00:00,2015-11-14 00:00:00,2402,837,410,3649
2015-11-14 00:00:00,2015-11-15 00:00:00,9,2,0,11
2015-11-15 00:00:00,2015-11-16 00:00:00,2035,695,533,3263
2015-11-16 00:00:00,2015-11-17 00:00:00,10915,2081,1531,14527
2015-11-17 00:00:00,2015-11-18 00:00:00,8398,3409,2813,14620
2015-11-18 00:00:00,2015-11-19 00:00:00,23154,4470,2339,29963
2015-11-19 00:00:00,2015-11-20 00:00:00,27572,3805,3001,34378
2015-11-20 00:00:00,2015-11-21 00:00:00,32837,11844,9202,53883
2015-11-21 00:00:00,2015-11-22 00:00:00,28490,8078,9249,45817
2015-11-22 00:00:00,2015-11-23 00:00:00,1287,1434,466,3187
2015-11-23 00:00:00,2015-11-24 00:00:00,954,546,170,1670
2015-11-24 00:00:00,2015-11-25 00:00:00,953,501,344,1798
2015-11-25 00:00:00,2015-11-26 00:00:00,1579,721,91,2391
2015-11-26 00:00:00,2015-11-27 00:00:00,194,169,74,437
2015-11-27 00:00:00,2015-11-28 00:00:00,2777,2310,313,5400
2015-11-28 00:00:00,2015-11-29 00:00:00,788,586,137,1511
2015-11-29 00:00:00,2015-11-30 00:00:00,366,211,47,624
2015-11-30 00:00:00,2015-12-01 00:00:00,387,303,50,740
2015-12-01 00:00:00,2015-12-02 00:00:00,919,155,326,1400
2015-12-02 00:00:00,2015-12-03 00:00:00,441,195,26,662
2015-12-03 00:00:00,2015-12-04 00:00:00,1420,706,303,2429
2015-12-04 00:00:00,2015-12-05 00:00:00,1670,1096,446,3212
2015-12-05 00:00:00,2015-12-06 00:00:00,1,16,56,73
2015-12-06 00:00:00,2015-12-07 00:00:00,10,8,0,18
2015-12-07 00:00:00,2015-12-08 00:00:00,2601,1509,257,4367
2015-12-08 00:00:00,2015-12-09 00:00:00,1826,785,111,2722
2015-12-09 00:00:00,2015-12-10 00:00:00,1800,1238,308,3346
2015-12-10 00:00:00,2015-12-11 00:00:00,1811,1324,493,3628
2015-12-11 00:00:00,2015-12-12 00:00:00,1397,2241,2813,6451
2015-12-12 00:00:00,2015-12-13 00:00:00,432,196,98,726
2015-12-13 00:00:00,2015-12-14 00:00:00,1734,544,397,2675
2015-12-14 00:00:00,2015-12-15 00:00:00,490,219,42,751
2015-12-15 00:00:00,2015-12-16 00:00:00,1593,1892,286,3771
2015-12-16 00:00:00,2015-12-17 00:00:00,1016,1097,132,2245
2015-12-17 00:00:00,2015-12-18 00:00:00,5580,1352,190,7122
2015-12-18 00:00:00,2015-12-19 00:00:00,5771,470,43,6284
2015-12-19 00:00:00,2015-12-20 00:00:00,59,617,27,703
2015-12-20 00:00:00,2015-12-21 00:00:00,264,134,23,421
2015-12-21 00:00:00,2015-12-22 00:00:00,7549,985,138,8672
2015-12-22 00:00:00,2015-12-23 00:00:00,7856,1499,656,10011
2015-12-23 00:00:00,2015-12-24 00:00:00,6542,2121,984,9647
2015-12-24 00:00:00,2015-12-25 00:00:00,2264,1383,568,4215
2015-12-25 00:00:00,2015-12-26 00:00:00,147,0,0,147
2015-12-26 00:00:00,2015-12-27 00:00:00,2576,98,10,2684
2015-12-27 00:00:00,2015-12-28 00:00:00,1711,309,89,2109
2015-12-28 00:00:00,2015-12-29 00:00:00,7569,1225,352,9146
2015-12-29 00:00:00,2015-12-30 00:00:00,3798,849,106,4753
2015-12-30 00:00:00,2015-12-31 00:00:00,6970,1003,264,8237
2015-12-31 00:00:00,2016-01-01 00:00:00,4189,602,1354,6145
2016-01-01 00:00:00,2016-01-02 00:00:00,623,12,0,635
2016-01-02 00:00:00,2016-01-03 00:00:00,15,45,265,325
2016-01-03 00:00:00,2016-01-04 00:00:00,140,55,4,199
2016-01-04 00:00:00,2016-01-05 00:00:00,7914,4440,1110,13464
2016-01-05 00:00:00,2016-01-06 00:00:00,1183,1477,295,2955
2016-01-06 00:00:00,2016-01-07 00:00:00,4030,4815,382,9227
2016-01-07 00:00:00,2016-01-08 00:00:00,2971,2748,130,5849
2016-01-08 00:00:00,2016-01-09 00:00:00,4689,2778,399,7866
2016-01-09 00:00:00,2016-01-10 00:00:00,38,14,3,55
2016-01-10 00:00:00,2016-01-11 00:00:00,4,1,0,5
2016-01-11 00:00:00,2016-01-12 00:00:00,5655,4282,701,10638
2016-01-12 00:00:00,2016-01-13 00:00:00,3886,5540,598,10024
2016-01-13 00:00:00,2016-01-14 00:00:00,2178,8587,329,11094
2016-01-14 00:00:00,2016-01-15 00:00:00,2180,10723,137,13040
2016-01-15 00:00:00,2016-01-16 00:00:00,7074,8074,181,15329
2016-01-16 00:00:00,2016-01-17 00:00:00,1313,184,28,1525
2016-01-17 00:00:00,2016-01-18 00:00:00,26547,2117,733,29397
2016-01-18 00:00:00,2016-01-19 00:00:00,13490,8252,1086,22828
2016-01-19 00:00:00,2016-01-20 00:00:00,6096,8279,441,14816
2016-01-20 00:00:00,2016-01-21 00:00:00,4713,6735,919,12367
2016-01-21 00:00:00,2016-01-22 00:00:00,4405,1910,419,6734
2016-01-22 00:00:00,2016-01-23 00:00:00,3515,363,71,3949
2016-01-23 00:00:00,2016-01-24 00:00:00,506,108,68,682
2016-01-24 00:00:00,2016-01-25 00:00:00,7,1,0,8
2016-01-25 00:00:00,2016-01-26 00:00:00,1473,1170,797,3440
2016-01-26 00:00:00,2016-01-27 00:00:00,335,154,7,496
2016-01-27 00:00:00,2016-01-28 00:00:00,20,1969,0,1989
2016-01-28 00:00:00,2016-01-29 00:00:00,4143,434,105,4682
2016-01-29 00:00:00,2016-01-30 00:00:00,1095,174,27,1296
2016-01-30 00:00:00,2016-01-31 00:00:00,1084,693,186,1963
2016-01-31 00:00:00,2016-02-01 00:00:00,263,22,0,285
2016-02-01 00:00:00,2016-02-02 00:00:00,8119,743,288,9150
2016-02-02 00:00:00,2016-02-03 00:00:00,2380,77,36,2493
2016-02-03 00:00:00,2016-02-04 00:00:00,1284,32,0,1316
2016-02-04 00:00:00,2016-02-05 00:00:00,150,11,83,244
2016-02-05 00:00:00,2016-02-06 00:00:00,3147,131,7,3285
2016-02-06 00:00:00,2016-02-07 00:00:00,386,329,62,777
2016-02-07 00:00:00,2016-02-08 00:00:00,3,1,0,4
2016-02-08 00:00:00,2016-02-09 00:00:00,45,6,0,51
2016-02-09 00:00:00,2016-02-10 00:00:00,22,28,0,50
2016-02-10 00:00:00,2016-02-11 00:00:00,1382,1611,212,3205
2016-02-11 00:00:00,2016-02-12 00:00:00,3448,6021,2400,11869
2016-02-12 00:00:00,2016-02-13 00:00:00,2623,356,178,3157
2016-02-13 00:00:00,2016-02-14 00:00:00,15,4,8,27
2016-02-14 00:00:00,2016-02-15 00:00:00,733,172,31,936
2016-02-15 00:00:00,2016-02-16 00:00:00,1762,184,43,1989
2016-02-16 00:00:00,2016-02-17 00:00:00,214,73,0,287
2016-02-17 00:00:00,2016-02-18 00:00:00,639,64,12,715
2016-02-18 00:00:00,2016-02-19 00:00:00,318,233,54,605
2016-02-19 00:00:00,2016-02-20 00:00:00,13046,218,1222,14486
2016-02-20 00:00:00,2016-02-21 00:00:00,10,2,0,12
2016-02-21 00:00:00,2016-02-22 00:00:00,4,9,7,20
2016-02-22 00:00:00,2016-02-23 00:00:00,340,74,117,531
2016-02-23 00:00:00,2016-02-24 00:00:00,186,56,15,257
2016-02-24 00:00:00,2016-02-25 00:00:00,593,212,40,845
2016-02-25 00:00:00,2016-02-26 00:00:00,930,503,702,2135
2016-02-26 00:00:00,2016-02-27 00:00:00,9,3,59,71
2016-02-27 00:00:00,2016-02-28 00:00:00,329,839,323,1491
2016-02-28 00:00:00,2016-02-29 00:00:00,1,1,0,2
2016-02-29 00:00:00,2016-03-01 00:00:00,14,17,53,84
2016-03-01 00:00:00,2016-03-02 00:00:00,303,108,11,422
2016-03-02 00:00:00,2016-03-03 00:00:00,401,508,68,977
2016-03-03 00:00:00,2016-03-04 00:00:00,7,5,19,31
2016-03-04 00:00:00,2016-03-05 00:00:00,529,307,224,1060
2016-03-05 00:00:00,2016-03-06 00:00:00,1898,1482,343,3723
2016-03-06 00:00:00,2016-03-07 00:00:00,730,1557,56,2343
2016-03-07 00:00:00,2016-03-08 00:00:00,1391,450,188,2029
2016-03-08 00:00:00,2016-03-09 00:00:00,1428,189,147,1764
2016-03-09 00:00:00,2016-03-10 00:00:00,3470,1077,1216,5763
2016-03-10 00:00:00,2016-03-11 00:00:00,6121,1524,1091,8736
2016-03-11 00:00:00,2016-03-12 00:00:00,4608,2544,772,7924
2016-03-12 00:00:00,2016-03-13 00:00:00,16,16,0,32
2016-03-13 00:00:00,2016-03-14 00:00:00,8,31,1,40
2016-03-14 00:00:00,2016-03-15 00:00:00,336,198,135,669
2016-03-15 00:00:00,2016-03-16 00:00:00,175,53,6,234
2016-03-16 00:00:00,2016-03-17 00:00:00,179,16,0,195
2016-03-17 00:00:00,2016-03-18 00:00:00,753,305,245,1303
2016-03-18 00:00:00,2016-03-19 00:00:00,4557,211,390,5158
2016-03-19 00:00:00,2016-03-20 00:00:00,2,10,0,12
2016-03-20 00:00:00,2016-03-21 00:00:00,90,5,0,95
2016-03-21 00:00:00,2016-03-22 00:00:00,543,172,490,1205
2016-03-22 00:00:00,2016-03-23 00:00:00,1116,447,460,2023
2016-03-23 00:00:00,2016-03-24 00:00:00,275,43,56,374
2016-03-24 00:00:00,2016-03-25 00:00:00,1577,200,380,2157
2016-03-25 00:00:00,2016-03-26 00:00:00,799,3,5,807
2016-03-26 00:00:00,2016-03-27 00:00:00,4,3,0,7
2016-03-27 00:00:00,2016-03-28 00:00:00,1,1,0,2
2016-03-28 00:00:00,2016-03-29 00:00:00,148,55,242,445
2016-03-29 00:00:00,2016-03-30 00:00:00,93,11,0,104
2016-03-30 00:00:00,2016-03-31 00:00:00,1378,883,1226,3487
2016-03-31 00:00:00,2016-04-01 00:00:00,1182,262,915,2359
2016-04-01 00:00:00,2016-04-02 00:00:00,2171,295,55,2521
2016-04-02 00:00:00,2016-04-03 00:00:00,2414,160,30,2604
2016-04-03 00:00:00,2016-04-04 00:00:00,1,0,65,66
2016-04-04 00:00:00,2016-04-05 00:00:00,353,662,79,1094
2016-04-05 00:00:00,2016-04-06 00:00:00,240,25,2,267
2016-04-06 00:00:00,2016-04-07 00:00:00,6,1,0,7
2016-04-07 00:00:00,2016-04-08 00:00:00,9,4,0,13
2016-04-08 00:00:00,2016-04-09 00:00:00,102,349,19,470
2016-04-09 00:00:00,2016-04-10 00:00:00,4,0,0,4
2016-04-10 00:00:00,2016-04-11 00:00:00,9,104,43,156
2016-04-11 00:00:00,2016-04-12 00:00:00,5,2,0,7
2016-04-12 00:00:00,2016-04-13 00:00:00,697,1035,245,1977
2016-04-13 00:00:00,2016-04-14 00:00:00,7,18,5,30
2016-04-14 00:00:00,2016-04-15 00:00:00,17,424,1601,2042
2016-04-15 00:00:00,2016-04-16 00:00:00,135,774,743,1652
2016-04-16 00:00:00,2016-04-17 00:00:00,10,79,153,242
2016-04-17 00:00:00,2016-04-18 00:00:00,6,11,0,17
2016-04-18 00:00:00,2016-04-19 00:00:00,95,733,369,1197
2016-04-19 00:00:00,2016-04-20 00:00:00,127,1216,881,2224
2016-04-20 00:00:00,2016-04-21 00:00:00,393,534,148,1075
2016-04-21 00:00:00,2016-04-22 00:00:00,286,897,77,1260
2016-04-22 00:00:00,2016-04-23 00:00:00,112,375,5,492
2016-04-23 00:00:00,2016-04-24 00:00:00,5,6,0,11
2016-04-24 00:00:00,2016-04-25 00:00:00,3,1,0,4
2016-04-25 00:00:00,2016-04-26 00:00:00,300,63,161,524
2016-04-26 00:00:00,2016-04-27 00:00:00,78,206,0,284
2016-04-27 00:00:00,2016-04-28 00:00:00,223,755,6,984
2016-04-28 00:00:00,2016-04-29 00:00:00,156,867,17,1040
2016-04-29 00:00:00,2016-04-30 00:00:00,225,887,107,1219
2016-04-30 00:00:00,2016-05-01 00:00:00,8,24,0,32
2016-05-01 00:00:00,2016-05-02 00:00:00,3,0,0,3
2016-05-02 00:00:00,2016-05-03 00:00:00,597,1430,100,2127
2016-05-03 00:00:00,2016-05-04 00:00:00,511,1509,39,2059
2016-05-04 00:00:00,2016-05-05 00:00:00,87,226,0,313
2016-05-05 00:00:00,2016-05-06 00:00:00,137,570,12,719
2016-05-06 00:00:00,2016-05-07 00:00:00,219,643,62,924
2016-05-07 00:00:00,2016-05-08 00:00:00,47,38,3,88
2016-05-08 00:00:00,2016-05-09 00:00:00,4,0,0,4
2016-05-09 00:00:00,2016-05-10 00:00:00,331,898,36,1265
2016-05-10 00:00:00,2016-05-11 00:00:00,171,556,9,736
2016-05-11 00:00:00,2016-05-12 00:00:00,1589,336,11,1936
2016-05-12 00:00:00,2016-05-13 00:00:00,155,481,14,650
2016-05-13 00:00:00,2016-05-14 00:00:00,94,188,15,297
2016-05-14 00:00:00,2016-05-15 00:00:00,4,0,0,4
2016-05-15 00:00:00,2016-05-16 00:00:00,3,2,0,5
2016-05-16 00:00:00,2016-05-17 00:00:00,149,679,50,878
2016-05-17 00:00:00,2016-05-18 00:00:00,447,952,59,1458
2016-05-18 00:00:00,2016-05-19 00:00:00,226,353,73,652
2016-05-19 00:00:00,2016-05-20 00:00:00,123,264,7,394
2016-05-20 00:00:00,2016-05-21 00:00:00,198,371,102,671
2016-05-21 00:00:00,2016-05-22 00:00:00,1,1,0,2
2016-05-22 00:00:00,2016-05-23 00:00:00,6,1,0,7
2016-05-23 00:00:00,2016-05-24 00:00:00,650,1664,246,2560
2016-05-24 00:00:00,2016-05-25 00:00:00,1178,1941,234,3353
2016-05-25 00:00:00,2016-05-26 00:00:00,981,1572,294,2847
2016-05-26 00:00:00,2016-05-27 00:00:00,5311,1204,75,6590
2016-05-27 00:00:00,2016-05-28 00:00:00,766,933,4,1703
2016-05-28 00:00:00,2016-05-29 00:00:00,1,2,0,3
2016-05-29 00:00:00,2016-05-30 00:00:00,2,2,0,4
2016-05-30 00:00:00,2016-05-31 00:00:00,578,1151,43,1772
2016-05-31 00:00:00,2016-06-01 00:00:00,657,836,43,1536
2016-06-01 00:00:00,2016-06-02 00:00:00,294,249,15,558
2016-06-02 00:00:00,2016-06-03 00:00:00,149,112,0,261
2016-06-03 00:00:00,2016-06-04 00:00:00,128,274,3,405
2016-06-04 00:00:00,2016-06-05 00:00:00,3,3,0,6
2016-06-05 00:00:00,2016-06-06 00:00:00,1,0,0,1
2016-06-06 00:00:00,2016-06-07 00:00:00,888,525,249,1662
2016-06-07 00:00:00,2016-06-08 00:00:00,935,609,343,1887
2016-06-08 00:00:00,2016-06-09 00:00:00,6,4,10,20
2016-06-09 00:00:00,2016-06-10 00:00:00,1,0,0,1
2016-06-10 00:00:00,2016-06-11 00:00:00,4,1,0,5
2016-06-11 00:00:00,2016-06-12 00:00:00,4,1,0,5
2016-06-12 00:00:00,2016-06-13 00:00:00,2,1,0,3
2016-06-13 00:00:00,2016-06-14 00:00:00,5,0,0,5
2016-06-14 00:00:00,2016-06-15 00:00:00,3,1,5,9
2016-06-15 00:00:00,2016-06-16 00:00:00,229,12,4,245
2016-06-16 00:00:00,2016-06-17 00:00:00,4,1,0,5
2016-06-17 00:00:00,2016-06-18 00:00:00,6,32,0,38
2016-06-18 00:00:00,2016-06-19 00:00:00,7,10,0,17
2016-06-19 00:00:00,2016-06-20 00:00:00,36,82,32,150
2016-06-20 00:00:00,2016-06-21 00:00:00,6,3,0,9
2016-06-21 00:00:00,2016-06-22 00:00:00,965,833,435,2233
2016-06-22 00:00:00,2016-06-23 00:00:00,22,16,0,38
2016-06-23 00:00:00,2016-06-24 00:00:00,109,1,5,115
2016-06-24 00:00:00,2016-06-25 00:00:00,5,11,0,16
2016-06-25 00:00:00,2016-06-26 00:00:00,3,7,0,10
2016-06-26 00:00:00,2016-06-27 00:00:00,10,2,7,19
2016-06-27 00:00:00,2016-06-28 00:00:00,7,1,0,8
2016-06-28 00:00:00,2016-06-29 00:00:00,391,706,191,1288
2016-06-29 00:00:00,2016-06-30 00:00:00,3,4,0,7
2016-06-30 00:00:00,2016-07-01 00:00:00,8,2,0,10
2016-07-01 00:00:00,2016-07-02 00:00:00,444,6,2,452
2016-07-02 00:00:00,2016-07-03 00:00:00,8,40,2,50
2016-07-03 00:00:00,2016-07-04 00:00:00,67,148,0,215
2016-07-04 00:00:00,2016-07-05 00:00:00,2,0,0,2
2016-07-05 00:00:00,2016-07-06 00:00:00,28,17,0,45
2016-07-06 00:00:00,2016-07-07 00:00:00,1209,802,867,2878
2016-07-07 00:00:00,2016-07-08 00:00:00,1031,281,0,1312
2016-07-08 00:00:00,2016-07-09 00:00:00,395,79,37,511
2016-07-09 00:00:00,2016-07-10 00:00:00,1,0,0,1
2016-07-10 00:00:00,2016-07-11 00:00:00,3,3,0,6
2016-07-11 00:00:00,2016-07-12 00:00:00,547,124,8,679
2016-07-12 00:00:00,2016-07-13 00:00:00,19,1,0,20
2016-07-13 00:00:00,2016-07-14 00:00:00,1053,167,412,1632
2016-07-14 00:00:00,2016-07-15 00:00:00,4,0,0,4
2016-07-15 00:00:00,2016-07-16 00:00:00,7,0,0,7
2016-07-16 00:00:00,2016-07-17 00:00:00,4,1,0,5
2016-07-17 00:00:00,2016-07-18 00:00:00,7,0,6,13
2016-07-18 00:00:00,2016-07-19 00:00:00,2,3,0,5
2016-07-19 00:00:00,2016-07-20 00:00:00,3,3,0,6
2016-07-20 00:00:00,2016-07-21 00:00:00,5,2,0,7
2016-07-21 00:00:00,2016-07-22 00:00:00,1578,1415,51,3044
2016-07-22 00:00:00,2016-07-23 00:00:00,466,582,43,1091
2016-07-23 00:00:00,2016-07-24 00:00:00,11,3,0,14
2016-07-24 00:00:00,2016-07-25 00:00:00,597,645,33,1275
2016-07-25 00:00:00,2016-07-26 00:00:00,663,623,25,1311
2016-07-26 00:00:00,2016-07-27 00:00:00,1526,1104,44,2674
2016-07-27 00:00:00,2016-07-28 00:00:00,392,650,205,1247
2016-07-28 00:00:00,2016-07-29 00:00:00,556,641,68,1265
2016-07-29 00:00:00,2016-07-30 00:00:00,206,395,44,645
2016-07-30 00:00:00,2016-07-31 00:00:00,6,0,0,6
2016-07-31 00:00:00,2016-08-01 00:00:00,3,0,0,3
2016-08-01 00:00:00,2016-08-02 00:00:00,549,474,28,1051
2016-08-02 00:00:00,2016-08-03 00:00:00,361,708,25,1094
2016-08-03 00:00:00,2016-08-04 00:00:00,8442,840,63,9345
2016-08-04 00:00:00,2016-08-05 00:00:00,858,399,9,1266
2016-08-05 00:00:00,2016-08-06 00:00:00,538,515,17,1070
2016-08-06 00:00:00,2016-08-07 00:00:00,4,2,0,6
2016-08-07 00:00:00,2016-08-08 00:00:00,12,1,0,13
2016-08-08 00:00:00,2016-08-09 00:00:00,3,1,0,4
2016-08-09 00:00:00,2016-08-10 00:00:00,498,219,11,728
2016-08-10 00:00:00,2016-08-11 00:00:00,2237,349,10,2596
2016-08-11 00:00:00,2016-08-12 00:00:00,1972,171,69,2212
2016-08-12 00:00:00,2016-08-13 00:00:00,1435,52,4,1491
2016-08-13 00:00:00,2016-08-14 00:00:00,4,2,0,6
2016-08-14 00:00:00,2016-08-15 00:00:00,5,4,0,9
2016-08-15 00:00:00,2016-08-16 00:00:00,3,2,0,5
2016-08-16 00:00:00,2016-08-17 00:00:00,2,1,0,3
2016-08-17 00:00:00,2016-08-18 00:00:00,15,15,3,33
2016-08-18 00:00:00,2016-08-19 00:00:00,1357,434,1,1792
2016-08-19 00:00:00,2016-08-20 00:00:00,972,194,6,1172
2016-08-20 00:00:00,2016-08-21 00:00:00,4,2,0,6
2016-08-21 00:00:00,2016-08-22 00:00:00,10,4,0,14
2016-08-22 00:00:00,2016-08-23 00:00:00,3,4,0,7
2016-08-23 00:00:00,2016-08-24 00:00:00,14,2361,2,2377
2016-08-24 00:00:00,2016-08-25 00:00:00,658,281,18,957
2016-08-25 00:00:00,2016-08-26 00:00:00,323,85,36,444
2016-08-26 00:00:00,2016-08-27 00:00:00,694,443,22,1159
2016-08-27 00:00:00,2016-08-28 00:00:00,3,1,0,4
2016-08-28 00:00:00,2016-08-29 00:00:00,29,9,0,38
2016-08-29 00:00:00,2016-08-30 00:00:00,950,382,127,1459
2016-08-30 00:00:00,2016-08-31 00:00:00,1,0,6,7
2016-08-31 00:00:00,2016-09-01 00:00:00,869,153,7,1029
2016-09-01 00:00:00,2016-09-02 00:00:00,6,1,0,7
2016-09-02 00:00:00,2016-09-03 00:00:00,1805,1019,66,2890
2016-09-03 00:00:00,2016-09-04 00:00:00,5,11,1,17
2016-09-04 00:00:00,2016-09-05 00:00:00,2,2,0,4
2016-09-05 00:00:00,2016-09-06 00:00:00,28,2,0,30
2016-09-06 00:00:00,2016-09-07 00:00:00,437,306,13,756
2016-09-07 00:00:00,2016-09-08 00:00:00,1954,833,7,2794
2016-09-08 00:00:00,2016-09-09 00:00:00,20,3,1,24
2016-09-09 00:00:00,2016-09-10 00:00:00,1506,420,1,1927
2016-09-10 00:00:00,2016-09-11 00:00:00,3,8,8,19
2016-09-11 00:00:00,2016-09-12 00:00:00,4,8,33,45
2016-09-12 00:00:00,2016-09-13 00:00:00,7,1,0,8
2016-09-13 00:00:00,2016-09-14 00:00:00,7,1,0,8
2016-09-14 00:00:00,2016-09-15 00:00:00,4,11,0,15
2016-09-15 00:00:00,2016-09-16 00:00:00,369,98,15,482
2016-09-16 00:00:00,2016-09-17 00:00:00,4,5,0,9
2016-09-17 00:00:00,2016-09-18 00:00:00,2,1,0,3
2016-09-18 00:00:00,2016-09-19 00:00:00,3,1902,0,1905
2016-09-19 00:00:00,2016-09-20 00:00:00,6,2,0,8
2016-09-20 00:00:00,2016-09-21 00:00:00,4,0,0,4
2016-09-21 00:00:00,2016-09-22 00:00:00,512,689,30,1231
2016-09-22 00:00:00,2016-09-23 00:00:00,22,24,0,46
2016-09-23 00:00:00,2016-09-24 00:00:00,19572,5961,815,26348
2016-09-24 00:00:00,2016-09-25 00:00:00,6,27,2,35
2016-09-25 00:00:00,2016-09-26 00:00:00,8,25,8,41
2016-09-26 00:00:00,2016-09-27 00:00:00,3,1248,0,1251
2016-09-27 00:00:00,2016-09-28 00:00:00,4,0,0,4
2016-09-28 00:00:00,2016-09-29 00:00:00,1321,31,0,1352
2016-09-29 00:00:00,2016-09-30 00:00:00,2232,548,14,2794
2016-09-30 00:00:00,2016-10-01 00:00:00,9985,2555,178,12718
2016-10-01 00:00:00,2016-10-02 00:00:00,218,10,0,228
2016-10-02 00:00:00,2016-10-03 00:00:00,67604,3882,777,72263
2016-10-03 00:00:00,2016-10-04 00:00:00,142499,8251,1031,151781
2016-10-04 00:00:00,2016-10-05 00:00:00,413046,40160,10108,463314
2016-10-05 00:00:00,2016-10-06 00:00:00,285469,40031,8851,334351
2016-10-06 00:00:00,2016-10-07 00:00:00,227888,34236,9512,271636
2016-10-07 00:00:00,2016-10-08 00:00:00,209976,39767,21336,271079
2016-10-08 00:00:00,2016-10-09 00:00:00,175161,26536,7493,209190
2016-10-09 00:00:00,2016-10-10 00:00:00,121925,20579,3404,145908
2016-10-10 00:00:00,2016-10-11 00:00:00,167242,22241,8376,197859
2016-10-11 00:00:00,2016-10-12 00:00:00,156840,23479,4716,185035
2016-10-12 00:00:00,2016-10-13 00:00:00,148859,38835,13574,201268
2016-10-13 00:00:00,2016-10-14 00:00:00,391850,32855,12112,436817
2016-10-14 00:00:00,2016-10-15 00:00:00,40352,22068,6346,68766
2016-10-15 00:00:00,2016-10-16 00:00:00,26164,13998,3639,43801
2016-10-16 00:00:00,2016-10-17 00:00:00,10207,10301,8147,28655
2016-10-17 00:00:00,2016-10-18 00:00:00,13546,8328,1987,23861
2016-10-18 00:00:00,2016-10-19 00:00:00,33748,7382,1937,43067
2016-10-19 00:00:00,2016-10-20 00:00:00,52450,11988,1941,66379
2016-10-20 00:00:00,2016-10-21 00:00:00,20124,3155,1047,24326
2016-10-21 00:00:00,2016-10-22 00:00:00,50210,11263,2037,63510
2016-10-22 00:00:00,2016-10-23 00:00:00,5471,4118,895,10484
2016-10-23 00:00:00,2016-10-24 00:00:00,28949,5438,1444,35831
2016-10-24 00:00:00,2016-10-25 00:00:00,31629,15416,6423,53468
2016-10-25 00:00:00,2016-10-26 00:00:00,30710,17896,8397,57003
2016-10-26 00:00:00,2016-10-27 00:00:00,11123,14691,2047,27861
2016-10-27 00:00:00,2016-10-28 00:00:00,10233,10054,2544,22831
2016-10-28 00:00:00,2016-10-29 00:00:00,8865,8570,1584,19019
2016-10-29 00:00:00,2016-10-30 00:00:00,7351,2344,730,10425
2016-10-30 00:00:00,2016-10-31 00:00:00,3107,1725,577,5409
2016-10-31 00:00:00,2016-11-01 00:00:00,2608,1829,374,4811
2016-11-01 00:00:00,2016-11-02 00:00:00,2574,2102,339,5015
2016-11-02 00:00:00,2016-11-03 00:00:00,2731,2093,107,4931
2016-11-03 00:00:00,2016-11-04 00:00:00,1228,637,20,1885
2016-11-04 00:00:00,2016-11-05 00:00:00,5256,1311,193,6760
2016-11-05 00:00:00,2016-11-06 00:00:00,12819,3855,382,17056
2016-11-06 00:00:00,2016-11-07 00:00:00,5463,2806,992,9261
2016-11-07 00:00:00,2016-11-08 00:00:00,3530,1001,66,4597
2016-11-08 00:00:00,2016-11-09 00:00:00,1790,1186,399,3375
2016-11-09 00:00:00,2016-11-10 00:00:00,3318,2008,388,5714
2016-11-10 00:00:00,2016-11-11 00:00:00,16520,1996,616,19132
2016-11-11 00:00:00,2016-11-12 00:00:00,910,867,42,1819
2016-11-12 00:00:00,2016-11-13 00:00:00,678,204,23,905
2016-11-13 00:00:00,2016-11-14 00:00:00,1298,1332,84,2714
2016-11-14 00:00:00,2016-11-15 00:00:00,1213,1230,120,2563
2016-11-15 00:00:00,2016-11-16 00:00:00,1786,1187,121,3094
2016-11-16 00:00:00,2016-11-17 00:00:00,2210,1019,219,3448
2016-11-17 00:00:00,2016-11-18 00:00:00,3689,15176,145,19010
2016-11-18 00:00:00,2016-11-19 00:00:00,2142,1741,176,4059
2016-11-19 00:00:00,2016-11-20 00:00:00,1809,1101,37,2947
2016-11-20 00:00:00,2016-11-21 00:00:00,89,2547,5,2641
2016-11-21 00:00:00,2016-11-22 00:00:00,334,398,141,873
2016-11-22 00:00:00,2016-11-23 00:00:00,63,458,34,555
2016-11-23 00:00:00,2016-11-24 00:00:00,2325,1432,112,3869
2016-11-24 00:00:00,2016-11-25 00:00:00,682,921,109,1712
2016-11-25 00:00:00,2016-11-26 00:00:00,1223,937,52,2212
2016-11-26 00:00:00,2016-11-27 00:00:00,2661,466,76,3203
2016-11-27 00:00:00,2016-11-28 00:00:00,6,38,25,69
2016-11-28 00:00:00,2016-11-29 00:00:00,118,433,19,570
2016-11-29 00:00:00,2016-11-30 00:00:00,30199,2192,2693,35084
2016-11-30 00:00:00,2016-12-01 00:00:00,26823,4074,4170,35067
2016-12-01 00:00:00,2016-12-02 00:00:00,24084,5353,1117,30554
2016-12-02 00:00:00,2016-12-03 00:00:00,9116,1627,1331,12074
2016-12-03 00:00:00,2016-12-04 00:00:00,7562,576,227,8365
2016-12-04 00:00:00,2016-12-05 00:00:00,10770,1238,571,12579
2016-12-05 00:00:00,2016-12-06 00:00:00,3258,637,446,4341
2016-12-06 00:00:00,2016-12-07 00:00:00,28023,3622,1370,33015
2016-12-07 00:00:00,2016-12-08 00:00:00,11009,2584,442,14035
2016-12-08 00:00:00,2016-12-09 00:00:00,10619,1416,1285,13320
2016-12-09 00:00:00,2016-12-10 00:00:00,26435,3455,1183,31073
2016-12-10 00:00:00,2016-12-11 00:00:00,6547,1028,971,8546
2016-12-11 00:00:00,2016-12-12 00:00:00,6172,1760,1100,9032
2016-12-12 00:00:00,2016-12-13 00:00:00,10896,2139,1242,14277
2016-12-13 00:00:00,2016-12-14 00:00:00,14470,2559,1353,18382
2016-12-14 00:00:00,2016-12-15 00:00:00,9012,990,622,10624
2016-12-15 00:00:00,2016-12-16 00:00:00,5313,1584,1252,8149
2016-12-16 00:00:00,2016-12-17 00:00:00,2136,961,176,3273
2016-12-17 00:00:00,2016-12-18 00:00:00,295,539,46,880
2016-12-18 00:00:00,2016-12-19 00:00:00,1195,1638,270,3103
2016-12-19 00:00:00,2016-12-20 00:00:00,2016,2420,205,4641
2016-12-20 00:00:00,2016-12-21 00:00:00,7882,4716,3811,16409
2016-12-21 00:00:00,2016-12-22 00:00:00,3436,1891,305,5632
2016-12-22 00:00:00,2016-12-23 00:00:00,2848,1022,160,4030
2016-12-23 00:00:00,2016-12-24 00:00:00,630,261,79,970
2016-12-24 00:00:00,2016-12-25 00:00:00,3088,2779,179,6046
2016-12-25 00:00:00,2016-12-26 00:00:00,2101,1925,577,4603
2016-12-26 00:00:00,2016-12-27 00:00:00,2708,1460,189,4357
2016-12-27 00:00:00,2016-12-28 00:00:00,1551,693,46,2290
2016-12-28 00:00:00,2016-12-29 00:00:00,885,546,77,1508
2016-12-29 00:00:00,2016-12-30 00:00:00,1928,1105,39,3072
2016-12-30 00:00:00,2016-12-31 00:00:00,2620,2685,124,5429
2016-12-31 00:00:00,2017-01-01 00:00:00,3034,1751,107,4892
2017-01-01 00:00:00,2017-01-02 00:00:00,914,507,15,1436
2017-01-02 00:00:00,2017-01-03 00:00:00,1024,477,179,1680
2017-01-03 00:00:00,2017-01-04 00:00:00,3324,1479,773,5576
2017-01-04 00:00:00,2017-01-05 00:00:00,589,510,12,1111
2017-01-05 00:00:00,2017-01-06 00:00:00,827,437,30,1294
2017-01-06 00:00:00,2017-01-07 00:00:00,159,359,19,537
2017-01-07 00:00:00,2017-01-08 00:00:00,3351,2572,136,6059
2017-01-08 00:00:00,2017-01-09 00:00:00,2713,2444,522,5679
2017-01-09 00:00:00,2017-01-10 00:00:00,2651,2030,91,4772
2017-01-10 00:00:00,2017-01-11 00:00:00,3371,1662,77,5110
2017-01-11 00:00:00,2017-01-12 00:00:00,1230,1828,22,3080
2017-01-12 00:00:00,2017-01-13 00:00:00,1714,2995,80,4789
2017-01-13 00:00:00,2017-01-14 00:00:00,1634,987,199,2820
2017-01-14 00:00:00,2017-01-15 00:00:00,161,56,120,337
2017-01-15 00:00:00,2017-01-16 00:00:00,1295,1338,71,2704
2017-01-16 00:00:00,2017-01-17 00:00:00,347,349,44,740
2017-01-17 00:00:00,2017-01-18 00:00:00,2534,1854,162,4550
2017-01-18 00:00:00,2017-01-19 00:00:00,922,1271,74,2267
2017-01-19 00:00:00,2017-01-20 00:00:00,1569,933,46,2548
2017-01-20 00:00:00,2017-01-21 00:00:00,1173,1056,59,2288
2017-01-21 00:00:00,2017-01-22 00:00:00,115,49,19,183
2017-01-22 00:00:00,2017-01-23 00:00:00,4,5,0,9
2017-01-23 00:00:00,2017-01-24 00:00:00,538,412,115,1065
2017-01-24 00:00:00,2017-01-25 00:00:00,342,302,8,652
2017-01-25 00:00:00,2017-01-26 00:00:00,844,403,76,1323
2017-01-26 00:00:00,2017-01-27 00:00:00,2437,1046,434,3917
2017-01-27 00:00:00,2017-01-28 00:00:00,281,3,0,284
2017-01-28 00:00:00,2017-01-29 00:00:00,306,134,64,504
2017-01-29 00:00:00,2017-01-30 00:00:00,13,22,9,44
2017-01-30 00:00:00,2017-01-31 00:00:00,569,303,144,1016
2017-01-31 00:00:00,2017-02-01 00:00:00,707,749,141,1597
2017-02-01 00:00:00,2017-02-02 00:00:00,904,463,129,1496
2017-02-02 00:00:00,2017-02-03 00:00:00,814,178,40,1032
2017-02-03 00:00:00,2017-02-04 00:00:00,261,266,4,531
2017-02-04 00:00:00,2017-02-05 00:00:00,6,6,0,12
2017-02-05 00:00:00,2017-02-06 00:00:00,1,3,0,4
2017-02-06 00:00:00,2017-02-07 00:00:00,1362,1192,64,2618
2017-02-07 00:00:00,2017-02-08 00:00:00,659,296,28,983
2017-02-08 00:00:00,2017-02-09 00:00:00,12969,2357,669,15995
2017-02-09 00:00:00,2017-02-10 00:00:00,1316,647,126,2089
2017-02-10 00:00:00,2017-02-11 00:00:00,1690,715,139,2544
2017-02-11 00:00:00,2017-02-12 00:00:00,3,4,0,7
2017-02-12 00:00:00,2017-02-13 00:00:00,1729,471,62,2262
2017-02-13 00:00:00,2017-02-14 00:00:00,386,197,8,591
2017-02-14 00:00:00,2017-02-15 00:00:00,717,380,20,1117
2017-02-15 00:00:00,2017-02-16 00:00:00,687,321,55,1063
2017-02-16 00:00:00,2017-02-17 00:00:00,28,43,211,282
2017-02-17 00:00:00,2017-02-18 00:00:00,519,234,114,867
2017-02-18 00:00:00,2017-02-19 00:00:00,4,0,0,4
2017-02-19 00:00:00,2017-02-20 00:00:00,1430,227,141,1798
2017-02-20 00:00:00,2017-02-21 00:00:00,3050,846,1064,4960
2017-02-21 00:00:00,2017-02-22 00:00:00,542,782,71,1395
2017-02-22 00:00:00,2017-02-23 00:00:00,2650,2920,981,6551
2017-02-23 00:00:00,2017-02-24 00:00:00,2801,1656,400,4857
2017-02-24 00:00:00,2017-02-25 00:00:00,954,401,89,1444
2017-02-25 00:00:00,2017-02-26 00:00:00,251,934,13,1198
2017-02-26 00:00:00,2017-02-27 00:00:00,920,2174,341,3435
2017-02-27 00:00:00,2017-02-28 00:00:00,318,80,31,429
2017-02-28 00:00:00,2017-03-01 00:00:00,2887,2096,165,5148
2017-03-01 00:00:00,2017-03-02 00:00:00,1738,1631,847,4216
2017-03-02 00:00:00,2017-03-03 00:00:00,256,195,16,467
2017-03-03 00:00:00,2017-03-04 00:00:00,1143,1489,372,3004
2017-03-04 00:00:00,2017-03-05 00:00:00,2406,1129,108,3643
2017-03-05 00:00:00,2017-03-06 00:00:00,580,208,17,805
2017-03-06 00:00:00,2017-03-07 00:00:00,626,928,62,1616
2017-03-07 00:00:00,2017-03-08 00:00:00,606,344,43,993
2017-03-08 00:00:00,2017-03-09 00:00:00,488,789,139,1416
2017-03-09 00:00:00,2017-03-10 00:00:00,23,14,1,38
2017-03-10 00:00:00,2017-03-11 00:00:00,29,46,0,75
2017-03-11 00:00:00,2017-03-12 00:00:00,5,20,3,28
2017-03-12 00:00:00,2017-03-13 00:00:00,2,7,2,11
2017-03-13 00:00:00,2017-03-14 00:00:00,100,72,116,288
2017-03-14 00:00:00,2017-03-15 00:00:00,7,3,0,10
2017-03-15 00:00:00,2017-03-16 00:00:00,424,40,55,519
2017-03-16 00:00:00,2017-03-17 00:00:00,2344,450,20,2814
2017-03-17 00:00:00,2017-03-18 00:00:00,1138,679,72,1889
2017-03-18 00:00:00,2017-03-19 00:00:00,546,955,360,1861
2017-03-19 00:00:00,2017-03-20 00:00:00,4,8,0,12
2017-03-20 00:00:00,2017-03-21 00:00:00,99,78,15,192
2017-03-21 00:00:00,2017-03-22 00:00:00,25,16,3,44
2017-03-22 00:00:00,2017-03-23 00:00:00,7,16,0,23
2017-03-23 00:00:00,2017-03-24 00:00:00,234,29,1,264
2017-03-24 00:00:00,2017-03-25 00:00:00,22,216,316,554
2017-03-25 00:00:00,2017-03-26 00:00:00,5,2,0,7
2017-03-26 00:00:00,2017-03-27 00:00:00,1096,37,9,1142
2017-03-27 00:00:00,2017-03-28 00:00:00,143,100,5,248
2017-03-28 00:00:00,2017-03-29 00:00:00,7,3,0,10
2017-03-29 00:00:00,2017-03-30 00:00:00,3,2,0,5
2017-03-30 00:00:00,2017-03-31 00:00:00,90,15,1,106
2017-03-31 00:00:00,2017-04-01 00:00:00,39,38,35,112
2017-04-01 00:00:00,2017-04-02 00:00:00,1075,374,110,1559
2017-04-02 00:00:00,2017-04-03 00:00:00,1,2,0,3
2017-04-03 00:00:00,2017-04-04 00:00:00,32,33,5,70
2017-04-04 00:00:00,2017-04-05 00:00:00,1,7,2,10
2017-04-05 00:00:00,2017-04-06 00:00:00,327,13,0,340
2017-04-06 00:00:00,2017-04-07 00:00:00,21,2,5,28
2017-04-07 00:00:00,2017-04-08 00:00:00,21,27,4,52
2017-04-08 00:00:00,2017-04-09 00:00:00,4,11,8,23
2017-04-09 00:00:00,2017-04-10 00:00:00,25,2,0,27
2017-04-10 00:00:00,2017-04-11 00:00:00,422,147,342,911
2017-04-11 00:00:00,2017-04-12 00:00:00,12,55,12,79
2017-04-12 00:00:00,2017-04-13 00:00:00,4047,45,5,4097
2017-04-13 00:00:00,2017-04-14 00:00:00,1856,499,72,2427
2017-04-14 00:00:00,2017-04-15 00:00:00,152,29,1,182
2017-04-15 00:00:00,2017-04-16 00:00:00,5948,370,74,6392
2017-04-16 00:00:00,2017-04-17 00:00:00,1659,74,9,1742
2017-04-17 00:00:00,2017-04-18 00:00:00,8,74,0,82
2017-04-18 00:00:00,2017-04-19 00:00:00,3486,257,92,3835
2017-04-19 00:00:00,2017-04-20 00:00:00,2291,551,65,2907
2017-04-20 00:00:00,2017-04-21 00:00:00,1426,275,69,1770
2017-04-21 00:00:00,2017-04-22 00:00:00,823,93,24,940
2017-04-22 00:00:00,2017-04-23 00:00:00,1255,167,69,1491
2017-04-23 00:00:00,2017-04-24 00:00:00,659,545,127,1331
2017-04-24 00:00:00,2017-04-25 00:00:00,754,897,126,1777
2017-04-25 00:00:00,2017-04-26 00:00:00,1540,7,0,1547
2017-04-26 00:00:00,2017-04-27 00:00:00,7,2,0,9
2017-04-27 00:00:00,2017-04-28 00:00:00,182,612,154,948
2017-04-28 00:00:00,2017-04-29 00:00:00,1016,541,221,1778
2017-04-29 00:00:00,2017-04-30 00:00:00,225,4,2,231
2017-04-30 00:00:00,2017-05-01 00:00:00,11,62,16,89
2017-05-01 00:00:00,2017-05-02 00:00:00,2166,96,43,2305
2017-05-02 00:00:00,2017-05-03 00:00:00,344,235,47,626
2017-05-03 00:00:00,2017-05-04 00:00:00,178,15,28,221
2017-05-04 00:00:00,2017-05-05 00:00:00,113,82,30,225
2017-05-05 00:00:00,2017-05-06 00:00:00,58,26,14,98
2017-05-06 00:00:00,2017-05-07 00:00:00,5,0,0,5
2017-05-07 00:00:00,2017-05-08 00:00:00,5,4,0,9
2017-05-08 00:00:00,2017-05-09 00:00:00,92,385,140,617
2017-05-09 00:00:00,2017-05-10 00:00:00,9,52,31,92
2017-05-10 00:00:00,2017-05-11 00:00:00,5,52,77,134
2017-05-11 00:00:00,2017-05-12 00:00:00,3,13,2,18
2017-05-12 00:00:00,2017-05-13 00:00:00,9,14,10,33
2017-05-13 00:00:00,2017-05-14 00:00:00,8,12,0,20
2017-05-14 00:00:00,2017-05-15 00:00:00,5,19,13,37
2017-05-15 00:00:00,2017-05-16 00:00:00,23,391,14,428
2017-05-16 00:00:00,2017-05-17 00:00:00,24,66,29,119
2017-05-17 00:00:00,2017-05-18 00:00:00,11,25,17,53
2017-05-18 00:00:00,2017-05-19 00:00:00,7,24,8,39
2017-05-19 00:00:00,2017-05-20 00:00:00,328,187,43,558
2017-05-20 00:00:00,2017-05-21 00:00:00,11,6,0,17
2017-05-21 00:00:00,2017-05-22 00:00:00,3,3,0,6
2017-05-22 00:00:00,2017-05-23 00:00:00,2135,6566,228,8929
2017-05-23 00:00:00,2017-05-24 00:00:00,1562,336,57,1955
2017-05-24 00:00:00,2017-05-25 00:00:00,562,182,112,856
2017-05-25 00:00:00,2017-05-26 00:00:00,24,3,1,28
2017-05-26 00:00:00,2017-05-27 00:00:00,12,11,0,23
2017-05-27 00:00:00,2017-05-28 00:00:00,31,45,9,85
2017-05-28 00:00:00,2017-05-29 00:00:00,4,4,2,10
2017-05-29 00:00:00,2017-05-30 00:00:00,6,5,2,13
2017-05-30 00:00:00,2017-05-31 00:00:00,8,3,0,11
2017-05-31 00:00:00,2017-06-01 00:00:00,16,2,3,21
2017-06-01 00:00:00,2017-06-02 00:00:00,8,6,0,14
2017-06-02 00:00:00,2017-06-03 00:00:00,10,9,3,22
2017-06-03 00:00:00,2017-06-04 00:00:00,37,12,0,49
2017-06-04 00:00:00,2017-06-05 00:00:00,4,0,0,4
2017-06-05 00:00:00,2017-06-06 00:00:00,17,9,5,31
2017-06-06 00:00:00,2017-06-07 00:00:00,2152,1,1,2154
2017-06-07 00:00:00,2017-06-08 00:00:00,11,13,6,30
2017-06-08 00:00:00,2017-06-09 00:00:00,87,36,3,126
2017-06-09 00:00:00,2017-06-10 00:00:00,7,14,3,24
2017-06-10 00:00:00,2017-06-11 00:00:00,6,3,0,9
2017-06-11 00:00:00,2017-06-12 00:00:00,1,1,0,2
2017-06-12 00:00:00,2017-06-13 00:00:00,368,1167,490,2025
2017-06-13 00:00:00,2017-06-14 00:00:00,4,5,1,10
2017-06-14 00:00:00,2017-06-15 00:00:00,155,458,49,662
2017-06-15 00:00:00,2017-06-16 00:00:00,9,27,7,43
2017-06-16 00:00:00,2017-06-17 00:00:00,13,3,4,20
2017-06-17 00:00:00,2017-06-18 00:00:00,6,3,1,10
2017-06-18 00:00:00,2017-06-19 00:00:00,7,14,0,21
2017-06-19 00:00:00,2017-06-20 00:00:00,6,8,0,14
2017-06-20 00:00:00,2017-06-21 00:00:00,4,2,0,6
2017-06-21 00:00:00,2017-06-22 00:00:00,5,1,0,6
2017-06-22 00:00:00,2017-06-23 00:00:00,82,9,1,92
2017-06-23 00:00:00,2017-06-24 00:00:00,11,13,2,26
2017-06-24 00:00:00,2017-06-25 00:00:00,1,5,0,6
2017-06-25 00:00:00,2017-06-26 00:00:00,1,4,0,5
2017-06-26 00:00:00,2017-06-27 00:00:00,54,56,4,114
2017-06-27 00:00:00,2017-06-28 00:00:00,50,59,0,109
2017-06-28 00:00:00,2017-06-29 00:00:00,7,1,0,8
2017-06-29 00:00:00,2017-06-30 00:00:00,1,0,0,1
2017-06-30 00:00:00,2017-07-01 00:00:00,3,2,1,6
2017-07-01 00:00:00,2017-07-02 00:00:00,410,314,100,824
2017-07-02 00:00:00,2017-07-03 00:00:00,219,1517,69,1805
2017-07-03 00:00:00,2017-07-04 00:00:00,5,1,0,6
2017-07-04 00:00:00,2017-07-05 00:00:00,1,1,0,2
2017-07-05 00:00:00,2017-07-06 00:00:00,8,19,3,30
2017-07-06 00:00:00,2017-07-07 00:00:00,6,1,0,7
2017-07-07 00:00:00,2017-07-08 00:00:00,11,91,124,226
2017-07-08 00:00:00,2017-07-09 00:00:00,22,56,0,78
2017-07-09 00:00:00,2017-07-10 00:00:00,12,158,255,425
2017-07-10 00:00:00,2017-07-11 00:00:00,6,0,0,6
2017-07-11 00:00:00,2017-07-12 00:00:00,10,122,8,140
2017-07-12 00:00:00,2017-07-13 00:00:00,2413,85,3,2501
2017-07-13 00:00:00,2017-07-14 00:00:00,28,127,93,248
2017-07-14 00:00:00,2017-07-15 00:00:00,3,14,0,17
2017-07-15 00:00:00,2017-07-16 00:00:00,0,8,0,8
2017-07-16 00:00:00,2017-07-17 00:00:00,0,0,0,0
2017-07-17 00:00:00,2017-07-18 00:00:00,8123,230,291,8644
2017-07-18 00:00:00,2017-07-19 00:00:00,7,3,3,13
2017-07-19 00:00:00,2017-07-20 00:00:00,165,135,19,319
2017-07-20 00:00:00,2017-07-21 00:00:00,5,1,0,6
2017-07-21 00:00:00,2017-07-22 00:00:00,3,5,18,26
2017-07-22 00:00:00,2017-07-23 00:00:00,17,1,4,22
2017-07-23 00:00:00,2017-07-24 00:00:00,2,0,10,12
2017-07-24 00:00:00,2017-07-25 00:00:00,16,27,0,43
2017-07-25 00:00:00,2017-07-26 00:00:00,5,3,0,8
2017-07-26 00:00:00,2017-07-27 00:00:00,2218,431,0,2649
2017-07-27 00:00:00,2017-07-28 00:00:00,8289,2207,24,10520
2017-07-28 00:00:00,2017-07-29 00:00:00,77,5,0,82
2017-07-29 00:00:00,2017-07-30 00:00:00,34,11,0,45
2017-07-30 00:00:00,2017-07-31 00:00:00,242,5,0,247
2017-07-31 00:00:00,2017-08-01 00:00:00,2150,110,3,2263
2017-08-01 00:00:00,2017-08-02 00:00:00,2299,88,13,2400
2017-08-02 00:00:00,2017-08-03 00:00:00,968,370,27,1365
2017-08-03 00:00:00,2017-08-04 00:00:00,4221,295,83,4599
2017-08-04 00:00:00,2017-08-05 00:00:00,12906,267,14,13187
2017-08-05 00:00:00,2017-08-06 00:00:00,339,17,36,392
2017-08-06 00:00:00,2017-08-07 00:00:00,4854,23,0,4877
2017-08-07 00:00:00,2017-08-08 00:00:00,118,24,0,142
2017-08-08 00:00:00,2017-08-09 00:00:00,34,113,3,150
2017-08-09 00:00:00,2017-08-10 00:00:00,696,351,20,1067
2017-08-10 00:00:00,2017-08-11 00:00:00,5015,147,49,5211
2017-08-11 00:00:00,2017-08-12 00:00:00,2501,98,195,2794
2017-08-12 00:00:00,2017-08-13 00:00:00,12,8,0,20
2017-08-13 00:00:00,2017-08-14 00:00:00,69,9,0,78
2017-08-14 00:00:00,2017-08-15 00:00:00,5522,210,116,5848
2017-08-15 00:00:00,2017-08-16 00:00:00,4,1,0,5
2017-08-16 00:00:00,2017-08-17 00:00:00,3182,247,111,3540
2017-08-17 00:00:00,2017-08-18 00:00:00,1465,143,15,1623
2017-08-18 00:00:00,2017-08-19 00:00:00,323,1337,7,1667
2017-08-19 00:00:00,2017-08-20 00:00:00,1019,92,22,1133
2017-08-20 00:00:00,2017-08-21 00:00:00,3739,753,103,4595
2017-08-21 00:00:00,2017-08-22 00:00:00,2660,238,7,2905
2017-08-22 00:00:00,2017-08-23 00:00:00,3035,67,5,3107
2017-08-23 00:00:00,2017-08-24 00:00:00,330,106,8,444
2017-08-24 00:00:00,2017-08-25 00:00:00,2449,228,92,2769
2017-08-25 00:00:00,2017-08-26 00:00:00,939,443,103,1485
2017-08-26 00:00:00,2017-08-27 00:00:00,222,1342,0,1564
2017-08-27 00:00:00,2017-08-28 00:00:00,22,8,1,31
2017-08-28 00:00:00,2017-08-29 00:00:00,584,118,3,705
2017-08-29 00:00:00,2017-08-30 00:00:00,6,3,4,13
2017-08-30 00:00:00,2017-08-31 00:00:00,98,11,46,155
2017-08-31 00:00:00,2017-09-01 00:00:00,33,223,0,256
2017-09-01 00:00:00,2017-09-02 00:00:00,1180,243,89,1512
2017-09-02 00:00:00,2017-09-03 00:00:00,7,1,0,8
2017-09-03 00:00:00,2017-09-04 00:00:00,2,4,1,7
2017-09-04 00:00:00,2017-09-05 00:00:00,226,106,328,660
2017-09-05 00:00:00,2017-09-06 00:00:00,173,139,39,351
2017-09-06 00:00:00,2017-09-07 00:00:00,14,101,5,120
2017-09-07 00:00:00,2017-09-08 00:00:00,506,93,46,645
2017-09-08 00:00:00,2017-09-09 00:00:00,843,86,4,933
2017-09-09 00:00:00,2017-09-10 00:00:00,5,0,0,5
2017-09-10 00:00:00,2017-09-11 00:00:00,8,4,0,12
2017-09-11 00:00:00,2017-09-12 00:00:00,5,62,0,67
2017-09-12 00:00:00,2017-09-13 00:00:00,108,58,5,171
2017-09-13 00:00:00,2017-09-14 00:00:00,919,78,80,1077
2017-09-14 00:00:00,2017-09-15 00:00:00,748,410,2140,3298
2017-09-15 00:00:00,2017-09-16 00:00:00,8,20,21,49
2017-09-16 00:00:00,2017-09-17 00:00:00,57,53,1156,1266
2017-09-17 00:00:00,2017-09-18 00:00:00,2501,404,1357,4262
2017-09-18 00:00:00,2017-09-19 00:00:00,132,0,0,132
2017-09-19 00:00:00,2017-09-20 00:00:00,149,11,0,160
2017-09-20 00:00:00,2017-09-21 00:00:00,19,16,0,35
2017-09-21 00:00:00,2017-09-22 00:00:00,70,66,0,136
2017-09-22 00:00:00,2017-09-23 00:00:00,1416,26,8,1450
2017-09-23 00:00:00,2017-09-24 00:00:00,8,3,0,11
2017-09-24 00:00:00,2017-09-25 00:00:00,0,0,0,0
2017-09-25 00:00:00,2017-09-26 00:00:00,2316,13,0,2329
2017-09-26 00:00:00,2017-09-27 00:00:00,7,1,39,47
2017-09-27 00:00:00,2017-09-28 00:00:00,38,13,42,93
2017-09-28 00:00:00,2017-09-29 00:00:00,76,13,0,89
2017-09-29 00:00:00,2017-09-30 00:00:00,11807,1050,717,13574
2017-09-30 00:00:00,2017-10-01 00:00:00,4,4,0,8
2017-10-01 00:00:00,2017-10-02 00:00:00,3,1,0,4
2017-10-02 00:00:00,2017-10-03 00:00:00,634,168,2,804
2017-10-03 00:00:00,2017-10-04 00:00:00,1128,127,166,1421
2017-10-04 00:00:00,2017-10-05 00:00:00,538,290,28,856
2017-10-05 00:00:00,2017-10-06 00:00:00,173,125,8,306
2017-10-06 00:00:00,2017-10-07 00:00:00,26,18,0,44
2017-10-07 00:00:00,2017-10-08 00:00:00,80,2,0,82
2017-10-08 00:00:00,2017-10-09 00:00:00,3,0,0,3
2017-10-09 00:00:00,2017-10-10 00:00:00,356,124,4,484
2015-10-10 00:00:00,2017-10-10 00:00:00,4122420,1001228,309340,5432988
