start_date,end_date,creates,edits,deletes,total
2014-04-25 00:00:00,2014-04-26 00:00:00,664,99,43,806
2014-04-26 00:00:00,2014-04-27 00:00:00,11,4,1,16
2014-04-27 00:00:00,2014-04-28 00:00:00,1395,328,794,2517
2014-04-28 00:00:00,2014-04-29 00:00:00,10255,156,353,10764
2014-04-29 00:00:00,2014-04-30 00:00:00,1627,215,43,1885
2014-04-30 00:00:00,2014-05-01 00:00:00,554,62,5,621
2014-05-01 00:00:00,2014-05-02 00:00:00,423,1607,416,2446
2014-05-02 00:00:00,2014-05-03 00:00:00,636,969,358,1963
2014-05-03 00:00:00,2014-05-04 00:00:00,31,7,19,57
2014-05-04 00:00:00,2014-05-05 00:00:00,643,401,434,1478
2014-05-05 00:00:00,2014-05-06 00:00:00,4576,203,612,5391
2014-05-06 00:00:00,2014-05-07 00:00:00,1027,348,228,1603
2014-05-07 00:00:00,2014-05-08 00:00:00,122,17,983,1122
2014-05-08 00:00:00,2014-05-09 00:00:00,52,168,50,270
2014-05-09 00:00:00,2014-05-10 00:00:00,685,19,8,712
2014-05-10 00:00:00,2014-05-11 00:00:00,6,1,0,7
2014-05-11 00:00:00,2014-05-12 00:00:00,31,21,39,91
2014-05-12 00:00:00,2014-05-13 00:00:00,8196,606,334,9136
2014-05-13 00:00:00,2014-05-14 00:00:00,65,115,19,199
2014-05-14 00:00:00,2014-05-15 00:00:00,165,354,77,596
2014-05-15 00:00:00,2014-05-16 00:00:00,120,32,0,152
2014-05-16 00:00:00,2014-05-17 00:00:00,10,0,0,10
2014-05-17 00:00:00,2014-05-18 00:00:00,9499,1205,274,10978
2014-05-18 00:00:00,2014-05-19 00:00:00,867,345,194,1406
2014-05-19 00:00:00,2014-05-20 00:00:00,1949,278,88,2315
2014-05-20 00:00:00,2014-05-21 00:00:00,2797,558,37,3392
2014-05-21 00:00:00,2014-05-22 00:00:00,256,472,68,796
2014-05-22 00:00:00,2014-05-23 00:00:00,80,468,231,779
2014-05-23 00:00:00,2014-05-24 00:00:00,704,111,17,832
2014-05-24 00:00:00,2014-05-25 00:00:00,555,10,0,565
2014-05-25 00:00:00,2014-05-26 00:00:00,126,41,8,175
2014-05-26 00:00:00,2014-05-27 00:00:00,589,48,49,686
2014-05-27 00:00:00,2014-05-28 00:00:00,2144,259,103,2506
2014-05-28 00:00:00,2014-05-29 00:00:00,3086,613,597,4296
2014-05-29 00:00:00,2014-05-30 00:00:00,496,21,2,519
2014-05-30 00:00:00,2014-05-31 00:00:00,574,180,30,784
2014-05-31 00:00:00,2014-06-01 00:00:00,145,6,1,152
2014-06-01 00:00:00,2014-06-02 00:00:00,17,5,0,22
2014-06-02 00:00:00,2014-06-03 00:00:00,238,115,27,380
2014-06-03 00:00:00,2014-06-04 00:00:00,3047,193,129,3369
2014-06-04 00:00:00,2014-06-05 00:00:00,11,15,2,28
2014-06-05 00:00:00,2014-06-06 00:00:00,2138,612,683,3433
2014-06-06 00:00:00,2014-06-07 00:00:00,3488,190,45,3723
2014-06-07 00:00:00,2014-06-08 00:00:00,4847,389,6,5242
2014-06-08 00:00:00,2014-06-09 00:00:00,8962,194,21,9177
2014-06-09 00:00:00,2014-06-10 00:00:00,1707,213,34,1954
2014-06-10 00:00:00,2014-06-11 00:00:00,983,20,20,1023
2014-06-11 00:00:00,2014-06-12 00:00:00,105,1090,1254,2449
2014-06-12 00:00:00,2014-06-13 00:00:00,102,65,5,172
2014-06-13 00:00:00,2014-06-14 00:00:00,868,166,58,1092
2014-06-14 00:00:00,2014-06-15 00:00:00,48,261,146,455
2014-06-15 00:00:00,2014-06-16 00:00:00,1282,112,306,1700
2014-06-16 00:00:00,2014-06-17 00:00:00,727,52,0,779
2014-06-17 00:00:00,2014-06-18 00:00:00,290,587,249,1126
2014-06-18 00:00:00,2014-06-19 00:00:00,1496,106,32,1634
2014-06-19 00:00:00,2014-06-20 00:00:00,2884,548,142,3574
2014-06-20 00:00:00,2014-06-21 00:00:00,2118,338,85,2541
2014-06-21 00:00:00,2014-06-22 00:00:00,160,115,3,278
2014-06-22 00:00:00,2014-06-23 00:00:00,1295,159,122,1576
2014-06-23 00:00:00,2014-06-24 00:00:00,2507,267,722,3496
2014-06-24 00:00:00,2014-06-25 00:00:00,1612,97,302,2011
2014-06-25 00:00:00,2014-06-26 00:00:00,1786,93,20,1899
2014-06-26 00:00:00,2014-06-27 00:00:00,628,53,81,762
2014-06-27 00:00:00,2014-06-28 00:00:00,375,33,2,410
2014-06-28 00:00:00,2014-06-29 00:00:00,8,1,0,9
2014-06-29 00:00:00,2014-06-30 00:00:00,325,307,834,1466
2014-06-30 00:00:00,2014-07-01 00:00:00,515,148,46,709
2014-07-01 00:00:00,2014-07-02 00:00:00,806,173,5,984
2014-07-02 00:00:00,2014-07-03 00:00:00,2676,67,46,2789
2014-07-03 00:00:00,2014-07-04 00:00:00,2128,152,69,2349
2014-07-04 00:00:00,2014-07-05 00:00:00,1757,216,19,1992
2014-07-05 00:00:00,2014-07-06 00:00:00,158,29,1,188
2014-07-06 00:00:00,2014-07-07 00:00:00,1574,187,57,1818
2014-07-07 00:00:00,2014-07-08 00:00:00,6862,387,383,7632
2014-07-08 00:00:00,2014-07-09 00:00:00,147,15,24,186
2014-07-09 00:00:00,2014-07-10 00:00:00,571,895,6,1472
2014-07-10 00:00:00,2014-07-11 00:00:00,247,116,7,370
2014-07-11 00:00:00,2014-07-12 00:00:00,677,32,431,1140
2014-07-12 00:00:00,2014-07-13 00:00:00,304,46,5,355
2014-07-13 00:00:00,2014-07-14 00:00:00,262,286,114,662
2014-07-14 00:00:00,2014-07-15 00:00:00,11,3,1,15
2014-07-15 00:00:00,2014-07-16 00:00:00,45,29,47,121
2014-07-16 00:00:00,2014-07-17 00:00:00,4055,260,183,4498
2014-07-17 00:00:00,2014-07-18 00:00:00,2051,38,14,2103
2014-07-18 00:00:00,2014-07-19 00:00:00,2823,52,6,2881
2014-07-19 00:00:00,2014-07-20 00:00:00,1822,37,1,1860
2014-07-20 00:00:00,2014-07-21 00:00:00,28,10,22,60
2014-07-21 00:00:00,2014-07-22 00:00:00,948,588,3,1539
2014-07-22 00:00:00,2014-07-23 00:00:00,137,15,17,169
2014-07-23 00:00:00,2014-07-24 00:00:00,99,14,1,114
2014-07-24 00:00:00,2014-07-25 00:00:00,976,427,149,1552
2014-07-25 00:00:00,2014-07-26 00:00:00,603,18,9,630
2014-07-26 00:00:00,2014-07-27 00:00:00,2666,180,193,3039
2014-07-27 00:00:00,2014-07-28 00:00:00,4,1,0,5
2014-07-28 00:00:00,2014-07-29 00:00:00,1693,45,21,1759
2014-07-29 00:00:00,2014-07-30 00:00:00,2124,30,10,2164
2014-07-30 00:00:00,2014-07-31 00:00:00,1171,77,100,1348
2014-07-31 00:00:00,2014-08-01 00:00:00,96,96,70,262
2014-08-01 00:00:00,2014-08-02 00:00:00,53,49,30,132
2014-08-02 00:00:00,2014-08-03 00:00:00,1238,53,4,1295
2014-08-03 00:00:00,2014-08-04 00:00:00,6772,201,254,7227
2014-08-04 00:00:00,2014-08-05 00:00:00,1102,312,5,1419
2014-08-05 00:00:00,2014-08-06 00:00:00,271,107,120,498
2014-08-06 00:00:00,2014-08-07 00:00:00,255,315,257,827
2014-08-07 00:00:00,2014-08-08 00:00:00,300,271,10,581
2014-08-08 00:00:00,2014-08-09 00:00:00,1628,17,1,1646
2014-08-09 00:00:00,2014-08-10 00:00:00,2,27,5,34
2014-08-10 00:00:00,2014-08-11 00:00:00,4,61,0,65
2014-08-11 00:00:00,2014-08-12 00:00:00,893,90,51,1034
2014-08-12 00:00:00,2014-08-13 00:00:00,825,59,11,895
2014-08-13 00:00:00,2014-08-14 00:00:00,2186,187,250,2623
2014-08-14 00:00:00,2014-08-15 00:00:00,8977,605,16,9598
2014-08-15 00:00:00,2014-08-16 00:00:00,5340,726,31,6097
2014-08-16 00:00:00,2014-08-17 00:00:00,1938,268,186,2392
2014-08-17 00:00:00,2014-08-18 00:00:00,4483,241,37,4761
2014-08-18 00:00:00,2014-08-19 00:00:00,4855,156,5,5016
2014-08-19 00:00:00,2014-08-20 00:00:00,1742,236,12,1990
2014-08-20 00:00:00,2014-08-21 00:00:00,1785,1205,88,3078
2014-08-21 00:00:00,2014-08-22 00:00:00,4194,1204,82,5480
2014-08-22 00:00:00,2014-08-23 00:00:00,1629,126,3,1758
2014-08-23 00:00:00,2014-08-24 00:00:00,7311,44,0,7355
2014-08-24 00:00:00,2014-08-25 00:00:00,54,38,21,113
2014-08-25 00:00:00,2014-08-26 00:00:00,2194,228,57,2479
2014-08-26 00:00:00,2014-08-27 00:00:00,2203,347,139,2689
2014-08-27 00:00:00,2014-08-28 00:00:00,7780,655,68,8503
2014-08-28 00:00:00,2014-08-29 00:00:00,10056,1005,49,11110
2014-08-29 00:00:00,2014-08-30 00:00:00,6729,575,10,7314
2014-08-30 00:00:00,2014-08-31 00:00:00,2687,472,11,3170
2014-08-31 00:00:00,2014-09-01 00:00:00,5608,355,107,6070
2014-09-01 00:00:00,2014-09-02 00:00:00,1492,290,67,1849
2014-09-02 00:00:00,2014-09-03 00:00:00,4606,456,60,5122
2014-09-03 00:00:00,2014-09-04 00:00:00,4247,403,70,4720
2014-09-04 00:00:00,2014-09-05 00:00:00,3315,168,10,3493
2014-09-05 00:00:00,2014-09-06 00:00:00,10636,951,61,11648
2014-09-06 00:00:00,2014-09-07 00:00:00,1029,39,0,1068
2014-09-07 00:00:00,2014-09-08 00:00:00,10728,612,17,11357
2014-09-08 00:00:00,2014-09-09 00:00:00,12853,1714,165,14732
2014-09-09 00:00:00,2014-09-10 00:00:00,8687,1266,121,10074
2014-09-10 00:00:00,2014-09-11 00:00:00,5050,761,58,5869
2014-09-11 00:00:00,2014-09-12 00:00:00,9878,999,35,10912
2014-09-12 00:00:00,2014-09-13 00:00:00,10094,597,121,10812
2014-09-13 00:00:00,2014-09-14 00:00:00,6370,536,76,6982
2014-09-14 00:00:00,2014-09-15 00:00:00,8923,320,35,9278
2014-09-15 00:00:00,2014-09-16 00:00:00,2894,497,210,3601
2014-09-16 00:00:00,2014-09-17 00:00:00,6516,520,128,7164
2014-09-17 00:00:00,2014-09-18 00:00:00,3391,1387,236,5014
2014-09-18 00:00:00,2014-09-19 00:00:00,5806,902,128,6836
2014-09-19 00:00:00,2014-09-20 00:00:00,13418,352,3,13773
2014-09-20 00:00:00,2014-09-21 00:00:00,10343,273,12,10628
2014-09-21 00:00:00,2014-09-22 00:00:00,4520,526,100,5146
2014-09-22 00:00:00,2014-09-23 00:00:00,9008,562,104,9674
2014-09-23 00:00:00,2014-09-24 00:00:00,4246,139,9,4394
2014-09-24 00:00:00,2014-09-25 00:00:00,2153,136,20,2309
2014-09-25 00:00:00,2014-09-26 00:00:00,4999,205,18,5222
2014-09-26 00:00:00,2014-09-27 00:00:00,1180,249,20,1449
2014-09-27 00:00:00,2014-09-28 00:00:00,3179,66,24,3269
2014-09-28 00:00:00,2014-09-29 00:00:00,4103,55,48,4206
2014-09-29 00:00:00,2014-09-30 00:00:00,5778,684,842,7304
2014-09-30 00:00:00,2014-10-01 00:00:00,1629,217,203,2049
2014-10-01 00:00:00,2014-10-02 00:00:00,1919,201,1,2121
2014-10-02 00:00:00,2014-10-03 00:00:00,169,45,0,214
2014-10-03 00:00:00,2014-10-04 00:00:00,4,15,0,19
2014-10-04 00:00:00,2014-10-05 00:00:00,10513,501,796,11810
2014-10-05 00:00:00,2014-10-06 00:00:00,17013,243,110,17366
2014-10-06 00:00:00,2014-10-07 00:00:00,2033,158,9,2200
2014-10-07 00:00:00,2014-10-08 00:00:00,2463,18,12,2493
2014-10-08 00:00:00,2014-10-09 00:00:00,3070,285,33,3388
2014-10-09 00:00:00,2014-10-10 00:00:00,4725,514,14,5253
2014-10-10 00:00:00,2014-10-11 00:00:00,8100,796,84,8980
2014-10-11 00:00:00,2014-10-12 00:00:00,902,138,417,1457
2014-10-12 00:00:00,2014-10-13 00:00:00,303,22,0,325
2014-10-13 00:00:00,2014-10-14 00:00:00,3970,78,11,4059
2014-10-14 00:00:00,2014-10-15 00:00:00,1254,51,53,1358
2014-10-15 00:00:00,2014-10-16 00:00:00,228,180,28,436
2014-10-16 00:00:00,2014-10-17 00:00:00,26,18,22,66
2014-10-17 00:00:00,2014-10-18 00:00:00,2803,138,11,2952
2014-10-18 00:00:00,2014-10-19 00:00:00,74,4,1,79
2014-10-19 00:00:00,2014-10-20 00:00:00,693,119,26,838
2014-10-20 00:00:00,2014-10-21 00:00:00,40,67,5,112
2014-10-21 00:00:00,2014-10-22 00:00:00,1601,721,39,2361
2014-10-22 00:00:00,2014-10-23 00:00:00,2334,364,75,2773
2014-10-23 00:00:00,2014-10-24 00:00:00,498,71,122,691
2014-10-24 00:00:00,2014-10-25 00:00:00,1315,10,9,1334
2014-10-25 00:00:00,2014-10-26 00:00:00,1107,34,0,1141
2014-10-26 00:00:00,2014-10-27 00:00:00,18020,260,1,18281
2014-10-27 00:00:00,2014-10-28 00:00:00,9930,462,361,10753
2014-10-28 00:00:00,2014-10-29 00:00:00,4513,476,158,5147
2014-10-29 00:00:00,2014-10-30 00:00:00,5391,304,190,5885
2014-10-30 00:00:00,2014-10-31 00:00:00,3822,778,33,4633
2014-10-31 00:00:00,2014-11-01 00:00:00,1102,827,229,2158
2014-11-01 00:00:00,2014-11-02 00:00:00,12,3,0,15
2014-11-02 00:00:00,2014-11-03 00:00:00,205,87,45,337
2014-11-03 00:00:00,2014-11-04 00:00:00,401,154,170,725
2014-11-04 00:00:00,2014-11-05 00:00:00,507,160,14,681
2014-11-05 00:00:00,2014-11-06 00:00:00,5012,106,37,5155
2014-11-06 00:00:00,2014-11-07 00:00:00,58,63,14,135
2014-11-07 00:00:00,2014-11-08 00:00:00,9165,420,664,10249
2014-11-08 00:00:00,2014-11-09 00:00:00,4460,829,44,5333
2014-11-09 00:00:00,2014-11-10 00:00:00,1179,201,26,1406
2014-11-10 00:00:00,2014-11-11 00:00:00,1251,602,62,1915
2014-11-11 00:00:00,2014-11-12 00:00:00,1428,134,165,1727
2014-11-12 00:00:00,2014-11-13 00:00:00,238,5641,14,5893
2014-11-13 00:00:00,2014-11-14 00:00:00,204,380,5,589
2014-11-14 00:00:00,2014-11-15 00:00:00,1440,263,27,1730
2014-11-15 00:00:00,2014-11-16 00:00:00,2546,518,3426,6490
2014-11-16 00:00:00,2014-11-17 00:00:00,2314,412,126,2852
2014-11-17 00:00:00,2014-11-18 00:00:00,26,54,19,99
2014-11-18 00:00:00,2014-11-19 00:00:00,306,182,18,506
2014-11-19 00:00:00,2014-11-20 00:00:00,124,19,56,199
2014-11-20 00:00:00,2014-11-21 00:00:00,268,28,0,296
2014-11-21 00:00:00,2014-11-22 00:00:00,752,30,42,824
2014-11-22 00:00:00,2014-11-23 00:00:00,3435,105,321,3861
2014-11-23 00:00:00,2014-11-24 00:00:00,8528,585,1894,11007
2014-11-24 00:00:00,2014-11-25 00:00:00,10774,536,612,11922
2014-11-25 00:00:00,2014-11-26 00:00:00,11887,550,730,13167
2014-11-26 00:00:00,2014-11-27 00:00:00,10915,528,1662,13105
2014-11-27 00:00:00,2014-11-28 00:00:00,6088,146,168,6402
2014-11-28 00:00:00,2014-11-29 00:00:00,8709,2080,869,11658
2014-11-29 00:00:00,2014-11-30 00:00:00,2590,140,17,2747
2014-11-30 00:00:00,2014-12-01 00:00:00,5267,236,103,5606
2014-12-01 00:00:00,2014-12-02 00:00:00,5672,699,2208,8579
2014-12-02 00:00:00,2014-12-03 00:00:00,2206,127,4,2337
2014-12-03 00:00:00,2014-12-04 00:00:00,2191,57,14,2262
2014-12-04 00:00:00,2014-12-05 00:00:00,1049,33,90,1172
2014-12-05 00:00:00,2014-12-06 00:00:00,469,44,344,857
2014-12-06 00:00:00,2014-12-07 00:00:00,2121,404,95,2620
2014-12-07 00:00:00,2014-12-08 00:00:00,1413,45,33,1491
2014-12-08 00:00:00,2014-12-09 00:00:00,142,27,13,182
2014-12-09 00:00:00,2014-12-10 00:00:00,416,150,6,572
2014-12-10 00:00:00,2014-12-11 00:00:00,41,38,5,84
2014-12-11 00:00:00,2014-12-12 00:00:00,3374,159,334,3867
2014-12-12 00:00:00,2014-12-13 00:00:00,299,44,1,344
2014-12-13 00:00:00,2014-12-14 00:00:00,1539,181,263,1983
2014-12-14 00:00:00,2014-12-15 00:00:00,4787,748,466,6001
2014-12-15 00:00:00,2014-12-16 00:00:00,3846,31,0,3877
2014-12-16 00:00:00,2014-12-17 00:00:00,2608,55,66,2729
2014-12-17 00:00:00,2014-12-18 00:00:00,98,45,0,143
2014-12-18 00:00:00,2014-12-19 00:00:00,2486,77,695,3258
2014-12-19 00:00:00,2014-12-20 00:00:00,2229,126,510,2865
2014-12-20 00:00:00,2014-12-21 00:00:00,1852,21,148,2021
2014-12-21 00:00:00,2014-12-22 00:00:00,2992,155,436,3583
2014-12-22 00:00:00,2014-12-23 00:00:00,364,249,22,635
2014-12-23 00:00:00,2014-12-24 00:00:00,1583,69,0,1652
2014-12-24 00:00:00,2014-12-25 00:00:00,3752,57,185,3994
2014-12-25 00:00:00,2014-12-26 00:00:00,45,23,61,129
2014-12-26 00:00:00,2014-12-27 00:00:00,3395,79,6,3480
2014-12-27 00:00:00,2014-12-28 00:00:00,10584,124,281,10989
2014-12-28 00:00:00,2014-12-29 00:00:00,5436,104,526,6066
2014-12-29 00:00:00,2014-12-30 00:00:00,1383,122,426,1931
2014-12-30 00:00:00,2014-12-31 00:00:00,3552,185,325,4062
2014-12-31 00:00:00,2015-01-01 00:00:00,3024,264,313,3601
2015-01-01 00:00:00,2015-01-02 00:00:00,2210,33,23,2266
2015-01-02 00:00:00,2015-01-03 00:00:00,2530,49,5,2584
2015-01-03 00:00:00,2015-01-04 00:00:00,146,25,18,189
2015-01-04 00:00:00,2015-01-05 00:00:00,326,103,51,480
2015-01-05 00:00:00,2015-01-06 00:00:00,3867,40,159,4066
2015-01-06 00:00:00,2015-01-07 00:00:00,14,25,212,251
2015-01-07 00:00:00,2015-01-08 00:00:00,4021,65,210,4296
2015-01-08 00:00:00,2015-01-09 00:00:00,17,10,0,27
2015-01-09 00:00:00,2015-01-10 00:00:00,26,12,1,39
2015-01-10 00:00:00,2015-01-11 00:00:00,29,204,16,249
2015-01-11 00:00:00,2015-01-12 00:00:00,3699,226,799,4724
2015-01-12 00:00:00,2015-01-13 00:00:00,151,87,1,239
2015-01-13 00:00:00,2015-01-14 00:00:00,15,7,0,22
2015-01-14 00:00:00,2015-01-15 00:00:00,311,65,3,379
2015-01-15 00:00:00,2015-01-16 00:00:00,505,170,101,776
2015-01-16 00:00:00,2015-01-17 00:00:00,2149,36,6,2191
2015-01-17 00:00:00,2015-01-18 00:00:00,3025,180,349,3554
2015-01-18 00:00:00,2015-01-19 00:00:00,1892,72,872,2836
2015-01-19 00:00:00,2015-01-20 00:00:00,585,21,0,606
2015-01-20 00:00:00,2015-01-21 00:00:00,343,49,4,396
2015-01-21 00:00:00,2015-01-22 00:00:00,3,1,0,4
2015-01-22 00:00:00,2015-01-23 00:00:00,2945,124,140,3209
2015-01-23 00:00:00,2015-01-24 00:00:00,1430,37,2,1469
2015-01-24 00:00:00,2015-01-25 00:00:00,628,421,83,1132
2015-01-25 00:00:00,2015-01-26 00:00:00,69,92,3,164
2015-01-26 00:00:00,2015-01-27 00:00:00,256,108,27,391
2015-01-27 00:00:00,2015-01-28 00:00:00,450,144,17,611
2015-01-28 00:00:00,2015-01-29 00:00:00,687,345,179,1211
2015-01-29 00:00:00,2015-01-30 00:00:00,3285,218,49,3552
2015-01-30 00:00:00,2015-01-31 00:00:00,1187,26,21,1234
2015-01-31 00:00:00,2015-02-01 00:00:00,302,86,28,416
2015-02-01 00:00:00,2015-02-02 00:00:00,864,171,25,1060
2015-02-02 00:00:00,2015-02-03 00:00:00,2704,135,21,2860
2015-02-03 00:00:00,2015-02-04 00:00:00,1169,101,3,1273
2015-02-04 00:00:00,2015-02-05 00:00:00,1309,282,54,1645
2015-02-05 00:00:00,2015-02-06 00:00:00,658,188,107,953
2015-02-06 00:00:00,2015-02-07 00:00:00,385,83,202,670
2015-02-07 00:00:00,2015-02-08 00:00:00,278,97,79,454
2015-02-08 00:00:00,2015-02-09 00:00:00,1546,29,1,1576
2015-02-09 00:00:00,2015-02-10 00:00:00,9836,1294,382,11512
2015-02-10 00:00:00,2015-02-11 00:00:00,8694,1098,85,9877
2015-02-11 00:00:00,2015-02-12 00:00:00,4686,1039,314,6039
2015-02-12 00:00:00,2015-02-13 00:00:00,12981,1320,1470,15771
2015-02-13 00:00:00,2015-02-14 00:00:00,21413,1191,114,22718
2015-02-14 00:00:00,2015-02-15 00:00:00,30076,1202,819,32097
2015-02-15 00:00:00,2015-02-16 00:00:00,62594,3110,1140,66844
2015-02-16 00:00:00,2015-02-17 00:00:00,46825,1761,426,49012
2015-02-17 00:00:00,2015-02-18 00:00:00,21146,1406,963,23515
2015-02-18 00:00:00,2015-02-19 00:00:00,20743,817,721,22281
2015-02-19 00:00:00,2015-02-20 00:00:00,40072,1156,1061,42289
2015-02-20 00:00:00,2015-02-21 00:00:00,31111,1412,1042,33565
2015-02-21 00:00:00,2015-02-22 00:00:00,29092,1312,773,31177
2015-02-22 00:00:00,2015-02-23 00:00:00,17844,1674,1078,20596
2015-02-23 00:00:00,2015-02-24 00:00:00,30789,2725,985,34499
2015-02-24 00:00:00,2015-02-25 00:00:00,28722,2617,432,31771
2015-02-25 00:00:00,2015-02-26 00:00:00,28250,1517,582,30349
2015-02-26 00:00:00,2015-02-27 00:00:00,25377,620,380,26377
2015-02-27 00:00:00,2015-02-28 00:00:00,41817,1908,1558,45283
2015-02-28 00:00:00,2015-03-01 00:00:00,32590,2488,438,35516
2015-03-01 00:00:00,2015-03-02 00:00:00,66777,1728,694,69199
2015-03-02 00:00:00,2015-03-03 00:00:00,38181,1570,752,40503
2015-03-03 00:00:00,2015-03-04 00:00:00,18545,2376,1616,22537
2015-03-04 00:00:00,2015-03-05 00:00:00,31179,3208,2185,36572
2015-03-05 00:00:00,2015-03-06 00:00:00,27158,959,967,29084
2015-03-06 00:00:00,2015-03-07 00:00:00,22669,1196,816,24681
2015-03-07 00:00:00,2015-03-08 00:00:00,13153,1071,920,15144
2015-03-08 00:00:00,2015-03-09 00:00:00,15591,1709,883,18183
2015-03-09 00:00:00,2015-03-10 00:00:00,6590,867,476,7933
2015-03-10 00:00:00,2015-03-11 00:00:00,10085,1131,663,11879
2015-03-11 00:00:00,2015-03-12 00:00:00,8835,305,5,9145
2015-03-12 00:00:00,2015-03-13 00:00:00,6474,620,38,7132
2015-03-13 00:00:00,2015-03-14 00:00:00,780,188,8,976
2015-03-14 00:00:00,2015-03-15 00:00:00,17131,1280,813,19224
2015-03-15 00:00:00,2015-03-16 00:00:00,19606,541,1055,21202
2015-03-16 00:00:00,2015-03-17 00:00:00,9923,537,209,10669
2015-03-17 00:00:00,2015-03-18 00:00:00,19177,333,45,19555
2015-03-18 00:00:00,2015-03-19 00:00:00,29086,407,258,29751
2015-03-19 00:00:00,2015-03-20 00:00:00,31088,422,297,31807
2015-03-20 00:00:00,2015-03-21 00:00:00,29337,291,71,29699
2015-03-21 00:00:00,2015-03-22 00:00:00,33454,296,652,34402
2015-03-22 00:00:00,2015-03-23 00:00:00,34047,781,420,35248
2015-03-23 00:00:00,2015-03-24 00:00:00,36481,1834,3090,41405
2015-03-24 00:00:00,2015-03-25 00:00:00,15991,3591,297,19879
2015-03-25 00:00:00,2015-03-26 00:00:00,32651,1194,529,34374
2015-03-26 00:00:00,2015-03-27 00:00:00,33406,695,3522,37623
2015-03-27 00:00:00,2015-03-28 00:00:00,37985,3064,5463,46512
2015-03-28 00:00:00,2015-03-29 00:00:00,19502,2833,591,22926
2015-03-29 00:00:00,2015-03-30 00:00:00,25493,4766,214,30473
2015-03-30 00:00:00,2015-03-31 00:00:00,8715,715,85,9515
2015-03-31 00:00:00,2015-04-01 00:00:00,20777,723,1714,23214
2015-04-01 00:00:00,2015-04-02 00:00:00,22976,563,1497,25036
2015-04-02 00:00:00,2015-04-03 00:00:00,52910,1339,1102,55351
2015-04-03 00:00:00,2015-04-04 00:00:00,26434,1918,588,28940
2015-04-04 00:00:00,2015-04-05 00:00:00,16999,420,117,17536
2015-04-05 00:00:00,2015-04-06 00:00:00,36545,429,51,37025
2015-04-06 00:00:00,2015-04-07 00:00:00,13472,266,1003,14741
2015-04-07 00:00:00,2015-04-08 00:00:00,27991,1860,442,30293
2015-04-08 00:00:00,2015-04-09 00:00:00,17487,1068,506,19061
2015-04-09 00:00:00,2015-04-10 00:00:00,13027,979,1908,15914
2015-04-10 00:00:00,2015-04-11 00:00:00,9500,872,237,10609
2015-04-11 00:00:00,2015-04-12 00:00:00,14296,226,43,14565
2015-04-12 00:00:00,2015-04-13 00:00:00,11602,584,183,12369
2015-04-13 00:00:00,2015-04-14 00:00:00,13229,822,486,14537
2015-04-14 00:00:00,2015-04-15 00:00:00,10272,417,372,11061
2015-04-15 00:00:00,2015-04-16 00:00:00,13630,548,582,14760
2015-04-16 00:00:00,2015-04-17 00:00:00,10744,538,501,11783
2015-04-17 00:00:00,2015-04-18 00:00:00,11415,1685,526,13626
2015-04-18 00:00:00,2015-04-19 00:00:00,9783,426,42,10251
2015-04-19 00:00:00,2015-04-20 00:00:00,14041,575,111,14727
2015-04-20 00:00:00,2015-04-21 00:00:00,9762,1760,609,12131
2015-04-21 00:00:00,2015-04-22 00:00:00,10585,1428,285,12298
2015-04-22 00:00:00,2015-04-23 00:00:00,6091,1153,546,7790
2015-04-23 00:00:00,2015-04-24 00:00:00,4608,978,2296,7882
2015-04-24 00:00:00,2015-04-25 00:00:00,2578,156,148,2882
2015-04-25 00:00:00,2015-04-26 00:00:00,309503,12075,2546,324124
2015-04-26 00:00:00,2015-04-27 00:00:00,818181,40636,14528,873345
2015-04-27 00:00:00,2015-04-28 00:00:00,889427,56791,26248,972466
2015-04-28 00:00:00,2015-04-29 00:00:00,884230,67819,38174,990223
2015-04-29 00:00:00,2015-04-30 00:00:00,1004708,97395,43722,1145825
2015-04-30 00:00:00,2015-05-01 00:00:00,970799,129035,39579,1139413
2015-05-01 00:00:00,2015-05-02 00:00:00,718069,87812,48711,854592
2015-05-02 00:00:00,2015-05-03 00:00:00,416440,177483,34631,628554
2015-05-03 00:00:00,2015-05-04 00:00:00,442381,100965,38259,581605
2015-05-04 00:00:00,2015-05-05 00:00:00,530229,114205,29769,674203
2015-05-05 00:00:00,2015-05-06 00:00:00,630374,124595,125290,880259
2015-05-06 00:00:00,2015-05-07 00:00:00,503795,113656,34687,652138
2015-05-07 00:00:00,2015-05-08 00:00:00,325725,109650,47645,483020
2015-05-08 00:00:00,2015-05-09 00:00:00,309824,79097,23381,412302
2015-05-09 00:00:00,2015-05-10 00:00:00,238535,84638,15327,338500
2015-05-10 00:00:00,2015-05-11 00:00:00,176420,52434,11412,240266
2015-05-11 00:00:00,2015-05-12 00:00:00,193729,164206,21793,379728
2015-05-12 00:00:00,2015-05-13 00:00:00,286337,158728,24332,469397
2015-05-13 00:00:00,2015-05-14 00:00:00,329583,174495,27658,531736
2015-05-14 00:00:00,2015-05-15 00:00:00,316225,236742,24615,577582
2015-05-15 00:00:00,2015-05-16 00:00:00,340072,156205,16021,512298
2015-05-16 00:00:00,2015-05-17 00:00:00,236260,47625,10168,294053
2015-05-17 00:00:00,2015-05-18 00:00:00,195827,21048,9599,226474
2015-05-18 00:00:00,2015-05-19 00:00:00,170165,57350,9418,236933
2015-05-19 00:00:00,2015-05-20 00:00:00,193068,17379,10396,220843
2015-05-20 00:00:00,2015-05-21 00:00:00,146095,15965,8670,170730
2015-05-21 00:00:00,2015-05-22 00:00:00,161551,20231,10071,191853
2015-05-22 00:00:00,2015-05-23 00:00:00,162307,15679,7030,185016
2015-05-23 00:00:00,2015-05-24 00:00:00,107401,11233,8328,126962
2015-05-24 00:00:00,2015-05-25 00:00:00,179449,14309,10402,204160
2015-05-25 00:00:00,2015-05-26 00:00:00,259360,166425,8478,434263
2015-05-26 00:00:00,2015-05-27 00:00:00,164111,35617,5218,204946
2015-05-27 00:00:00,2015-05-28 00:00:00,133995,10503,2814,147312
2015-05-28 00:00:00,2015-05-29 00:00:00,132206,15599,4579,152384
2015-05-29 00:00:00,2015-05-30 00:00:00,74385,13284,8388,96057
2015-05-30 00:00:00,2015-05-31 00:00:00,76720,13426,5631,95777
2015-05-31 00:00:00,2015-06-01 00:00:00,99824,17172,3440,120436
2015-06-01 00:00:00,2015-06-02 00:00:00,102023,13481,3037,118541
2015-06-02 00:00:00,2015-06-03 00:00:00,99069,7807,1905,108781
2015-06-03 00:00:00,2015-06-04 00:00:00,65869,7056,1692,74617
2015-06-04 00:00:00,2015-06-05 00:00:00,85769,8074,5942,99785
2015-06-05 00:00:00,2015-06-06 00:00:00,54836,6580,4784,66200
2015-06-06 00:00:00,2015-06-07 00:00:00,45353,8693,4784,58830
2015-06-07 00:00:00,2015-06-08 00:00:00,66777,6055,1941,74773
2015-06-08 00:00:00,2015-06-09 00:00:00,78339,8866,2645,89850
2015-06-09 00:00:00,2015-06-10 00:00:00,66286,8366,4118,78770
2015-06-10 00:00:00,2015-06-11 00:00:00,60168,4252,1031,65451
2015-06-11 00:00:00,2015-06-12 00:00:00,57266,3369,1329,61964
2015-06-12 00:00:00,2015-06-13 00:00:00,67078,2042,731,69851
2015-06-13 00:00:00,2015-06-14 00:00:00,60928,1923,1048,63899
2015-06-14 00:00:00,2015-06-15 00:00:00,60590,2447,735,63772
2015-06-15 00:00:00,2015-06-16 00:00:00,79534,5232,3314,88080
2015-06-16 00:00:00,2015-06-17 00:00:00,69004,6515,5115,80634
2015-06-17 00:00:00,2015-06-18 00:00:00,69463,4340,1198,75001
2015-06-18 00:00:00,2015-06-19 00:00:00,86234,2618,837,89689
2015-06-19 00:00:00,2015-06-20 00:00:00,56832,5121,1271,63224
2015-06-20 00:00:00,2015-06-21 00:00:00,56268,5943,2878,65089
2015-06-21 00:00:00,2015-06-22 00:00:00,60818,11942,2348,75108
2015-06-22 00:00:00,2015-06-23 00:00:00,65907,3509,1306,70722
2015-06-23 00:00:00,2015-06-24 00:00:00,71834,6036,2135,80005
2015-06-24 00:00:00,2015-06-25 00:00:00,58253,2597,2538,63388
2015-06-25 00:00:00,2015-06-26 00:00:00,77675,4423,1645,83743
2015-06-26 00:00:00,2015-06-27 00:00:00,62454,3967,1216,67637
2015-06-27 00:00:00,2015-06-28 00:00:00,54319,3581,783,58683
2015-06-28 00:00:00,2015-06-29 00:00:00,43413,2574,569,46556
2015-06-29 00:00:00,2015-06-30 00:00:00,62956,3720,1580,68256
2015-06-30 00:00:00,2015-07-01 00:00:00,46552,1867,2260,50679
2015-07-01 00:00:00,2015-07-02 00:00:00,39308,13454,3608,56370
2015-07-02 00:00:00,2015-07-03 00:00:00,40356,12122,1812,54290
2015-07-03 00:00:00,2015-07-04 00:00:00,25944,2643,1878,30465
2015-07-04 00:00:00,2015-07-05 00:00:00,39265,3327,781,43373
2015-07-05 00:00:00,2015-07-06 00:00:00,19043,4341,1933,25317
2015-07-06 00:00:00,2015-07-07 00:00:00,36325,5945,4843,47113
2015-07-07 00:00:00,2015-07-08 00:00:00,23793,1775,1011,26579
2015-07-08 00:00:00,2015-07-09 00:00:00,32751,11389,4266,48406
2015-07-09 00:00:00,2015-07-10 00:00:00,21588,2915,3888,28391
2015-07-10 00:00:00,2015-07-11 00:00:00,34293,1972,1658,37923
2015-07-11 00:00:00,2015-07-12 00:00:00,31984,2481,8431,42896
2015-07-12 00:00:00,2015-07-13 00:00:00,15881,784,3554,20219
2015-07-13 00:00:00,2015-07-14 00:00:00,42555,2394,1306,46255
2015-07-14 00:00:00,2015-07-15 00:00:00,36696,3440,617,40753
2015-07-15 00:00:00,2015-07-16 00:00:00,16017,2764,1188,19969
2015-07-16 00:00:00,2015-07-17 00:00:00,13948,1871,1143,16962
2015-07-17 00:00:00,2015-07-18 00:00:00,10312,7076,2086,19474
2015-07-18 00:00:00,2015-07-19 00:00:00,12353,239,578,13170
2015-07-19 00:00:00,2015-07-20 00:00:00,12036,1306,452,13794
2015-07-20 00:00:00,2015-07-21 00:00:00,15623,1394,160,17177
2015-07-21 00:00:00,2015-07-22 00:00:00,13860,529,266,14655
2015-07-22 00:00:00,2015-07-23 00:00:00,22833,690,984,24507
2015-07-23 00:00:00,2015-07-24 00:00:00,13939,1270,2865,18074
2015-07-24 00:00:00,2015-07-25 00:00:00,7861,908,932,9701
2015-07-25 00:00:00,2015-07-26 00:00:00,8718,526,78,9322
2015-07-26 00:00:00,2015-07-27 00:00:00,25378,910,327,26615
2015-07-27 00:00:00,2015-07-28 00:00:00,33238,764,757,34759
2015-07-28 00:00:00,2015-07-29 00:00:00,17835,2053,1403,21291
2015-07-29 00:00:00,2015-07-30 00:00:00,25708,4254,901,30863
2015-07-30 00:00:00,2015-07-31 00:00:00,16716,713,1990,19419
2015-07-31 00:00:00,2015-08-01 00:00:00,19860,1719,1430,23009
2015-08-01 00:00:00,2015-08-02 00:00:00,5519,514,647,6680
2015-08-02 00:00:00,2015-08-03 00:00:00,15182,1239,692,17113
2015-08-03 00:00:00,2015-08-04 00:00:00,9406,1089,1446,11941
2015-08-04 00:00:00,2015-08-05 00:00:00,12054,1040,1405,14499
2015-08-05 00:00:00,2015-08-06 00:00:00,12292,2197,1721,16210
2015-08-06 00:00:00,2015-08-07 00:00:00,16296,4853,640,21789
2015-08-07 00:00:00,2015-08-08 00:00:00,10459,1516,195,12170
2015-08-08 00:00:00,2015-08-09 00:00:00,9881,317,712,10910
2015-08-09 00:00:00,2015-08-10 00:00:00,28205,1134,624,29963
2015-08-10 00:00:00,2015-08-11 00:00:00,15196,935,261,16392
2015-08-11 00:00:00,2015-08-12 00:00:00,5672,1089,119,6880
2015-08-12 00:00:00,2015-08-13 00:00:00,16538,1488,277,18303
2015-08-13 00:00:00,2015-08-14 00:00:00,10661,399,381,11441
2015-08-14 00:00:00,2015-08-15 00:00:00,10622,707,68,11397
2015-08-15 00:00:00,2015-08-16 00:00:00,13612,138,175,13925
2015-08-16 00:00:00,2015-08-17 00:00:00,14377,554,81,15012
2015-08-17 00:00:00,2015-08-18 00:00:00,10545,578,97,11220
2015-08-18 00:00:00,2015-08-19 00:00:00,17027,1202,129,18358
2015-08-19 00:00:00,2015-08-20 00:00:00,12165,427,126,12718
2015-08-20 00:00:00,2015-08-21 00:00:00,8175,899,26,9100
2015-08-21 00:00:00,2015-08-22 00:00:00,7045,61,102,7208
2015-08-22 00:00:00,2015-08-23 00:00:00,8699,485,324,9508
2015-08-23 00:00:00,2015-08-24 00:00:00,10893,159,13,11065
2015-08-24 00:00:00,2015-08-25 00:00:00,10140,314,444,10898
2015-08-25 00:00:00,2015-08-26 00:00:00,15836,314,75,16225
2015-08-26 00:00:00,2015-08-27 00:00:00,25576,424,5549,31549
2015-08-27 00:00:00,2015-08-28 00:00:00,13818,1192,384,15394
2015-08-28 00:00:00,2015-08-29 00:00:00,9134,661,417,10212
2015-08-29 00:00:00,2015-08-30 00:00:00,5117,448,86,5651
2015-08-30 00:00:00,2015-08-31 00:00:00,6091,106,2401,8598
2015-08-31 00:00:00,2015-09-01 00:00:00,13287,237,148,13672
2015-09-01 00:00:00,2015-09-02 00:00:00,17241,862,60,18163
2015-09-02 00:00:00,2015-09-03 00:00:00,11597,242,559,12398
2015-09-03 00:00:00,2015-09-04 00:00:00,17717,322,460,18499
2015-09-04 00:00:00,2015-09-05 00:00:00,9974,1480,87,11541
2015-09-05 00:00:00,2015-09-06 00:00:00,25980,393,53,26426
2015-09-06 00:00:00,2015-09-07 00:00:00,13277,91,36,13404
2015-09-07 00:00:00,2015-09-08 00:00:00,8520,382,12,8914
2015-09-08 00:00:00,2015-09-09 00:00:00,11941,900,872,13713
2015-09-09 00:00:00,2015-09-10 00:00:00,12383,245,1272,13900
2015-09-10 00:00:00,2015-09-11 00:00:00,7238,167,30,7435
2015-09-11 00:00:00,2015-09-12 00:00:00,36369,1170,610,38149
2015-09-12 00:00:00,2015-09-13 00:00:00,2832,69,55,2956
2015-09-13 00:00:00,2015-09-14 00:00:00,14374,644,32,15050
2015-09-14 00:00:00,2015-09-15 00:00:00,5113,408,17,5538
2015-09-15 00:00:00,2015-09-16 00:00:00,12824,557,327,13708
2015-09-16 00:00:00,2015-09-17 00:00:00,7960,139,11,8110
2015-09-17 00:00:00,2015-09-18 00:00:00,8285,171,235,8691
2015-09-18 00:00:00,2015-09-19 00:00:00,6966,101,8,7075
2015-09-19 00:00:00,2015-09-20 00:00:00,7052,124,12,7188
2015-09-20 00:00:00,2015-09-21 00:00:00,9454,310,21,9785
2015-09-21 00:00:00,2015-09-22 00:00:00,4705,394,47,5146
2015-09-22 00:00:00,2015-09-23 00:00:00,15389,367,379,16135
2015-09-23 00:00:00,2015-09-24 00:00:00,8233,606,238,9077
2015-09-24 00:00:00,2015-09-25 00:00:00,9714,723,643,11080
2015-09-25 00:00:00,2015-09-26 00:00:00,12800,205,134,13139
2015-09-26 00:00:00,2015-09-27 00:00:00,9675,230,179,10084
2015-09-27 00:00:00,2015-09-28 00:00:00,9391,288,185,9864
2015-09-28 00:00:00,2015-09-29 00:00:00,12743,244,275,13262
2015-09-29 00:00:00,2015-09-30 00:00:00,15630,1422,475,17527
2015-09-30 00:00:00,2015-10-01 00:00:00,22027,807,207,23041
2015-10-01 00:00:00,2015-10-02 00:00:00,15880,1427,106,17413
2015-10-02 00:00:00,2015-10-03 00:00:00,14044,167,95,14306
2015-10-03 00:00:00,2015-10-04 00:00:00,6497,177,57,6731
2015-10-04 00:00:00,2015-10-05 00:00:00,16938,275,715,17928
2015-10-05 00:00:00,2015-10-06 00:00:00,6026,154,53,6233
2015-10-06 00:00:00,2015-10-07 00:00:00,11302,691,106,12099
2015-10-07 00:00:00,2015-10-08 00:00:00,16466,856,435,17757
2015-10-08 00:00:00,2015-10-09 00:00:00,16642,402,54,17098
2015-10-09 00:00:00,2015-10-10 00:00:00,4742,203,550,5495
2015-10-10 00:00:00,2015-10-11 00:00:00,20433,404,127,20964
2015-10-11 00:00:00,2015-10-12 00:00:00,22739,1970,147,24856
2015-10-12 00:00:00,2015-10-13 00:00:00,5698,518,276,6492
2015-10-13 00:00:00,2015-10-14 00:00:00,14296,2304,827,17427
2015-10-14 00:00:00,2015-10-15 00:00:00,6378,590,60,7028
2015-10-15 00:00:00,2015-10-16 00:00:00,9810,308,189,10307
2015-10-16 00:00:00,2015-10-17 00:00:00,18890,6797,305,25992
2015-10-17 00:00:00,2015-10-18 00:00:00,8937,198,19,9154
2015-10-18 00:00:00,2015-10-19 00:00:00,17087,500,77,17664
2015-10-19 00:00:00,2015-10-20 00:00:00,19522,379,67,19968
2015-10-20 00:00:00,2015-10-21 00:00:00,25310,409,72,25791
2015-10-21 00:00:00,2015-10-22 00:00:00,13999,693,936,15628
2015-10-22 00:00:00,2015-10-23 00:00:00,15937,642,270,16849
2015-10-23 00:00:00,2015-10-24 00:00:00,23132,314,45,23491
2015-10-24 00:00:00,2015-10-25 00:00:00,15122,349,1331,16802
2015-10-25 00:00:00,2015-10-26 00:00:00,52270,989,164,53423
2015-10-26 00:00:00,2015-10-27 00:00:00,12400,669,187,13256
2015-10-27 00:00:00,2015-10-28 00:00:00,11985,310,48,12343
2015-10-28 00:00:00,2015-10-29 00:00:00,24700,439,206,25345
2015-10-29 00:00:00,2015-10-30 00:00:00,8084,696,211,8991
2015-10-30 00:00:00,2015-10-31 00:00:00,11504,539,42,12085
2015-10-31 00:00:00,2015-11-01 00:00:00,7302,396,159,7857
2015-11-01 00:00:00,2015-11-02 00:00:00,17088,2290,1161,20539
2015-11-02 00:00:00,2015-11-03 00:00:00,7450,1135,1866,10451
2015-11-03 00:00:00,2015-11-04 00:00:00,5024,827,447,6298
2015-11-04 00:00:00,2015-11-05 00:00:00,6124,1607,122,7853
2015-11-05 00:00:00,2015-11-06 00:00:00,2663,1528,126,4317
2015-11-06 00:00:00,2015-11-07 00:00:00,12034,590,237,12861
2015-11-07 00:00:00,2015-11-08 00:00:00,334,312,144,790
2015-11-08 00:00:00,2015-11-09 00:00:00,6288,1879,906,9073
2015-11-09 00:00:00,2015-11-10 00:00:00,4242,2695,1231,8168
2015-11-10 00:00:00,2015-11-11 00:00:00,3069,222,280,3571
2015-11-11 00:00:00,2015-11-12 00:00:00,3170,1541,83,4794
2015-11-12 00:00:00,2015-11-13 00:00:00,7503,633,7,8143
2015-11-13 00:00:00,2015-11-14 00:00:00,14341,1637,2082,18060
2015-11-14 00:00:00,2015-11-15 00:00:00,16377,129,53,16559
2015-11-15 00:00:00,2015-11-16 00:00:00,12607,2241,428,15276
2015-11-16 00:00:00,2015-11-17 00:00:00,12037,825,446,13308
2015-11-17 00:00:00,2015-11-18 00:00:00,6646,2640,691,9977
2015-11-18 00:00:00,2015-11-19 00:00:00,19744,2715,567,23026
2015-11-19 00:00:00,2015-11-20 00:00:00,11573,2404,417,14394
2015-11-20 00:00:00,2015-11-21 00:00:00,24749,1795,342,26886
2015-11-21 00:00:00,2015-11-22 00:00:00,18730,853,302,19885
2015-11-22 00:00:00,2015-11-23 00:00:00,24022,2275,1714,28011
2015-11-23 00:00:00,2015-11-24 00:00:00,37340,657,325,38322
2015-11-24 00:00:00,2015-11-25 00:00:00,13007,1072,291,14370
2015-11-25 00:00:00,2015-11-26 00:00:00,27888,1104,88,29080
2015-11-26 00:00:00,2015-11-27 00:00:00,13180,510,471,14161
2015-11-27 00:00:00,2015-11-28 00:00:00,10881,838,137,11856
2015-11-28 00:00:00,2015-11-29 00:00:00,27305,986,1021,29312
2015-11-29 00:00:00,2015-11-30 00:00:00,21156,444,602,22202
2015-11-30 00:00:00,2015-12-01 00:00:00,13604,357,51,14012
2015-12-01 00:00:00,2015-12-02 00:00:00,21933,2062,1054,25049
2015-12-02 00:00:00,2015-12-03 00:00:00,11662,2229,556,14447
2015-12-03 00:00:00,2015-12-04 00:00:00,7283,3222,975,11480
2015-12-04 00:00:00,2015-12-05 00:00:00,9206,535,268,10009
2015-12-05 00:00:00,2015-12-06 00:00:00,5824,218,88,6130
2015-12-06 00:00:00,2015-12-07 00:00:00,3272,85,15,3372
2015-12-07 00:00:00,2015-12-08 00:00:00,5537,868,86,6491
2015-12-08 00:00:00,2015-12-09 00:00:00,3305,175,51,3531
2015-12-09 00:00:00,2015-12-10 00:00:00,6012,76,243,6331
2015-12-10 00:00:00,2015-12-11 00:00:00,4546,351,74,4971
2015-12-11 00:00:00,2015-12-12 00:00:00,2606,82,83,2771
2015-12-12 00:00:00,2015-12-13 00:00:00,9022,149,268,9439
2015-12-13 00:00:00,2015-12-14 00:00:00,3633,1684,64,5381
2015-12-14 00:00:00,2015-12-15 00:00:00,431,23,7,461
2015-12-15 00:00:00,2015-12-16 00:00:00,7807,277,41,8125
2015-12-16 00:00:00,2015-12-17 00:00:00,6673,170,183,7026
2015-12-17 00:00:00,2015-12-18 00:00:00,515,63,11,589
2015-12-18 00:00:00,2015-12-19 00:00:00,2508,142,94,2744
2015-12-19 00:00:00,2015-12-20 00:00:00,2940,146,53,3139
2015-12-20 00:00:00,2015-12-21 00:00:00,1626,156,4,1786
2015-12-21 00:00:00,2015-12-22 00:00:00,2429,248,11,2688
2015-12-22 00:00:00,2015-12-23 00:00:00,2280,228,26,2534
2015-12-23 00:00:00,2015-12-24 00:00:00,1710,262,120,2092
2015-12-24 00:00:00,2015-12-25 00:00:00,1193,60,23,1276
2015-12-25 00:00:00,2015-12-26 00:00:00,3113,131,8,3252
2015-12-26 00:00:00,2015-12-27 00:00:00,1578,371,230,2179
2015-12-27 00:00:00,2015-12-28 00:00:00,14321,632,12009,26962
2015-12-28 00:00:00,2015-12-29 00:00:00,3541,312,131,3984
2015-12-29 00:00:00,2015-12-30 00:00:00,5676,238,69,5983
2015-12-30 00:00:00,2015-12-31 00:00:00,3673,177,346,4196
2015-12-31 00:00:00,2016-01-01 00:00:00,1336,749,61,2146
2016-01-01 00:00:00,2016-01-02 00:00:00,3248,634,909,4791
2016-01-02 00:00:00,2016-01-03 00:00:00,3911,142,18,4071
2016-01-03 00:00:00,2016-01-04 00:00:00,3158,390,161,3709
2016-01-04 00:00:00,2016-01-05 00:00:00,524,157,15,696
2016-01-05 00:00:00,2016-01-06 00:00:00,6261,138,288,6687
2016-01-06 00:00:00,2016-01-07 00:00:00,1189,872,2631,4692
2016-01-07 00:00:00,2016-01-08 00:00:00,4636,330,381,5347
2016-01-08 00:00:00,2016-01-09 00:00:00,2291,169,241,2701
2016-01-09 00:00:00,2016-01-10 00:00:00,63,5,1012,1080
2016-01-10 00:00:00,2016-01-11 00:00:00,5845,728,418,6991
2016-01-11 00:00:00,2016-01-12 00:00:00,2932,110,16,3058
2016-01-12 00:00:00,2016-01-13 00:00:00,1236,58,3,1297
2016-01-13 00:00:00,2016-01-14 00:00:00,1819,242,64,2125
2016-01-14 00:00:00,2016-01-15 00:00:00,1229,224,144,1597
2016-01-15 00:00:00,2016-01-16 00:00:00,1431,67,86,1584
2016-01-16 00:00:00,2016-01-17 00:00:00,1875,101,7,1983
2016-01-17 00:00:00,2016-01-18 00:00:00,1873,708,604,3185
2016-01-18 00:00:00,2016-01-19 00:00:00,4746,123,91,4960
2016-01-19 00:00:00,2016-01-20 00:00:00,5857,393,122,6372
2016-01-20 00:00:00,2016-01-21 00:00:00,4239,224,394,4857
2016-01-21 00:00:00,2016-01-22 00:00:00,1500,385,24,1909
2016-01-22 00:00:00,2016-01-23 00:00:00,1886,150,599,2635
2016-01-23 00:00:00,2016-01-24 00:00:00,1194,125,67,1386
2016-01-24 00:00:00,2016-01-25 00:00:00,2109,88,200,2397
2016-01-25 00:00:00,2016-01-26 00:00:00,1580,50,1,1631
2016-01-26 00:00:00,2016-01-27 00:00:00,2347,131,14,2492
2016-01-27 00:00:00,2016-01-28 00:00:00,1055,59,0,1114
2016-01-28 00:00:00,2016-01-29 00:00:00,3681,51,369,4101
2016-01-29 00:00:00,2016-01-30 00:00:00,1502,132,155,1789
2016-01-30 00:00:00,2016-01-31 00:00:00,1094,159,19,1272
2016-01-31 00:00:00,2016-02-01 00:00:00,1378,149,265,1792
2016-02-01 00:00:00,2016-02-02 00:00:00,1315,39,8,1362
2016-02-02 00:00:00,2016-02-03 00:00:00,1618,121,239,1978
2016-02-03 00:00:00,2016-02-04 00:00:00,1687,157,9,1853
2016-02-04 00:00:00,2016-02-05 00:00:00,1486,92,30,1608
2016-02-05 00:00:00,2016-02-06 00:00:00,33103,150,39,33292
2016-02-06 00:00:00,2016-02-07 00:00:00,29182,198,817,30197
2016-02-07 00:00:00,2016-02-08 00:00:00,6524,164,63,6751
2016-02-08 00:00:00,2016-02-09 00:00:00,1692,122,0,1814
2016-02-09 00:00:00,2016-02-10 00:00:00,2540,176,252,2968
2016-02-10 00:00:00,2016-02-11 00:00:00,5416,177,146,5739
2016-02-11 00:00:00,2016-02-12 00:00:00,8583,96,137,8816
2016-02-12 00:00:00,2016-02-13 00:00:00,16180,631,230,17041
2016-02-13 00:00:00,2016-02-14 00:00:00,29353,877,12109,42339
2016-02-14 00:00:00,2016-02-15 00:00:00,5313,1227,425,6965
2016-02-15 00:00:00,2016-02-16 00:00:00,3152,2547,1572,7271
2016-02-16 00:00:00,2016-02-17 00:00:00,3597,951,224,4772
2016-02-17 00:00:00,2016-02-18 00:00:00,2852,4367,743,7962
2016-02-18 00:00:00,2016-02-19 00:00:00,4462,626,946,6034
2016-02-19 00:00:00,2016-02-20 00:00:00,7138,4597,810,12545
2016-02-20 00:00:00,2016-02-21 00:00:00,3355,3467,813,7635
2016-02-21 00:00:00,2016-02-22 00:00:00,11750,1291,799,13840
2016-02-22 00:00:00,2016-02-23 00:00:00,1458,1128,220,2806
2016-02-23 00:00:00,2016-02-24 00:00:00,10310,2103,290,12703
2016-02-24 00:00:00,2016-02-25 00:00:00,11430,2485,1178,15093
2016-02-25 00:00:00,2016-02-26 00:00:00,9752,1814,588,12154
2016-02-26 00:00:00,2016-02-27 00:00:00,10315,1630,410,12355
2016-02-27 00:00:00,2016-02-28 00:00:00,7113,1879,928,9920
2016-02-28 00:00:00,2016-02-29 00:00:00,15433,923,259,16615
2016-02-29 00:00:00,2016-03-01 00:00:00,15455,468,1467,17390
2016-03-01 00:00:00,2016-03-02 00:00:00,25491,2189,281,27961
2016-03-02 00:00:00,2016-03-03 00:00:00,12311,792,258,13361
2016-03-03 00:00:00,2016-03-04 00:00:00,19148,619,708,20475
2016-03-04 00:00:00,2016-03-05 00:00:00,14286,499,98,14883
2016-03-05 00:00:00,2016-03-06 00:00:00,10571,2021,703,13295
2016-03-06 00:00:00,2016-03-07 00:00:00,4045,666,242,4953
2016-03-07 00:00:00,2016-03-08 00:00:00,19916,151,26,20093
2016-03-08 00:00:00,2016-03-09 00:00:00,13300,199,337,13836
2016-03-09 00:00:00,2016-03-10 00:00:00,13385,179,434,13998
2016-03-10 00:00:00,2016-03-11 00:00:00,8220,385,285,8890
2016-03-11 00:00:00,2016-03-12 00:00:00,16252,260,221,16733
2016-03-12 00:00:00,2016-03-13 00:00:00,4479,634,423,5536
2016-03-13 00:00:00,2016-03-14 00:00:00,1622,528,165,2315
2016-03-14 00:00:00,2016-03-15 00:00:00,6922,303,12,7237
2016-03-15 00:00:00,2016-03-16 00:00:00,7999,380,61,8440
2016-03-16 00:00:00,2016-03-17 00:00:00,12025,419,2737,15181
2016-03-17 00:00:00,2016-03-18 00:00:00,2351,844,308,3503
2016-03-18 00:00:00,2016-03-19 00:00:00,1473,193,32,1698
2016-03-19 00:00:00,2016-03-20 00:00:00,1935,290,8,2233
2016-03-20 00:00:00,2016-03-21 00:00:00,4874,1050,104,6028
2016-03-21 00:00:00,2016-03-22 00:00:00,2084,502,85,2671
2016-03-22 00:00:00,2016-03-23 00:00:00,4087,92,10,4189
2016-03-23 00:00:00,2016-03-24 00:00:00,5452,307,79,5838
2016-03-24 00:00:00,2016-03-25 00:00:00,1437,1487,1219,4143
2016-03-25 00:00:00,2016-03-26 00:00:00,15535,780,109,16424
2016-03-26 00:00:00,2016-03-27 00:00:00,6074,237,52,6363
2016-03-27 00:00:00,2016-03-28 00:00:00,8132,1073,271,9476
2016-03-28 00:00:00,2016-03-29 00:00:00,13853,371,10,14234
2016-03-29 00:00:00,2016-03-30 00:00:00,7747,47,2,7796
2016-03-30 00:00:00,2016-03-31 00:00:00,6881,379,162,7422
2016-03-31 00:00:00,2016-04-01 00:00:00,17507,704,139,18350
2016-04-01 00:00:00,2016-04-02 00:00:00,14523,1121,505,16149
2016-04-02 00:00:00,2016-04-03 00:00:00,17151,1251,654,19056
2016-04-03 00:00:00,2016-04-04 00:00:00,7741,710,40,8491
2016-04-04 00:00:00,2016-04-05 00:00:00,12814,969,232,14015
2016-04-05 00:00:00,2016-04-06 00:00:00,12425,1165,136,13726
2016-04-06 00:00:00,2016-04-07 00:00:00,10416,1733,421,12570
2016-04-07 00:00:00,2016-04-08 00:00:00,19927,498,123,20548
2016-04-08 00:00:00,2016-04-09 00:00:00,12067,1333,268,13668
2016-04-09 00:00:00,2016-04-10 00:00:00,8791,2942,40,11773
2016-04-10 00:00:00,2016-04-11 00:00:00,13008,1541,49,14598
2016-04-11 00:00:00,2016-04-12 00:00:00,13667,555,129,14351
2016-04-12 00:00:00,2016-04-13 00:00:00,10201,579,70,10850
2016-04-13 00:00:00,2016-04-14 00:00:00,12030,248,26,12304
2016-04-14 00:00:00,2016-04-15 00:00:00,6182,965,169,7316
2016-04-15 00:00:00,2016-04-16 00:00:00,9932,539,126,10597
2016-04-16 00:00:00,2016-04-17 00:00:00,10376,229,72,10677
2016-04-17 00:00:00,2016-04-18 00:00:00,6340,265,88,6693
2016-04-18 00:00:00,2016-04-19 00:00:00,1060,127,3,1190
2016-04-19 00:00:00,2016-04-20 00:00:00,6498,185,227,6910
2016-04-20 00:00:00,2016-04-21 00:00:00,10699,169,43,10911
2016-04-21 00:00:00,2016-04-22 00:00:00,15722,493,36,16251
2016-04-22 00:00:00,2016-04-23 00:00:00,12693,1733,197,14623
2016-04-23 00:00:00,2016-04-24 00:00:00,18639,435,7,19081
2016-04-24 00:00:00,2016-04-25 00:00:00,15808,355,75,16238
2014-04-25 00:00:00,2016-04-25 00:00:00,20921820,3466630,1155372,25543822
